Rk,Player,Pos,Age,Tm,G,GS,MP,FG,FGA,FG%,3P,3PA,3P%,2P,2PA,2P%,eFG%,FT,FTA,FT%,ORB,DRB,TRB,AST,STL,BLK,TOV,PF,PTS
1,Alex Abrines\abrinal01,SG,25,OKC,31,2,588,56,157,0.357,41,127,0.323,15,30,0.5,0.487,12,13,0.923,5,43,48,20,17,6,14,53,165
2,Quincy Acy\acyqu01,PF,28,PHO,10,0,123,4,18,0.222,2,15,0.133,2,3,0.667,0.278,7,10,0.7,3,22,25,8,1,4,4,24,17
3,Jaylen Adams\adamsja01,PG,22,ATL,10,0,45,4,12,0.333,3,7,0.429,1,5,0.2,0.458,2,2,1,1,3,4,6,3,1,2,4,13
4,Steven Adams\adamsst01,C,25,OKC,54,54,1830,343,563,0.609,0,1,0,343,562,0.61,0.609,120,218,0.55,244,272,516,89,84,41,87,138,806
5,Bam Adebayo\adebaba01,C,21,MIA,55,6,1210,161,288,0.559,1,9,0.111,160,279,0.573,0.561,106,149,0.711,112,256,368,107,41,42,76,140,429
6,Deng Adel\adelde01,SF,21,CLE,11,3,158,9,30,0.3,5,20,0.25,4,10,0.4,0.383,2,2,1,2,11,13,4,1,4,5,11,25
7,DeVaughn Akoon-Purcell\akoonde01,SG,25,DEN,7,0,22,3,10,0.3,0,4,0,3,6,0.5,0.3,1,2,0.5,1,3,4,6,2,0,2,4,7
8,LaMarcus Aldridge\aldrila01,C,33,SAS,58,58,1896,476,935,0.509,5,23,0.217,471,912,0.516,0.512,261,309,0.845,182,340,522,148,30,71,109,129,1218
9,Rawle Alkins\alkinra01,SG,21,CHI,2,0,4,1,4,0.25,1,1,1,0,3,0,0.375,0,0,,3,0,3,2,1,0,0,0,3
10,Grayson Allen\allengr01,SG,23,UTA,28,1,276,34,109,0.312,19,69,0.275,15,40,0.375,0.399,27,36,0.75,1,10,11,17,4,3,16,30,114
11,Jarrett Allen\allenja01,C,20,BRK,56,56,1496,242,419,0.578,6,36,0.167,236,383,0.616,0.585,139,187,0.743,142,338,480,84,32,85,77,126,629
12,Kadeem Allen\allenka01,SG,26,NYK,8,1,178,27,56,0.482,6,12,0.5,21,44,0.477,0.536,14,19,0.737,4,20,24,32,5,1,5,21,74
13,Al-Farouq Aminu\aminual01,PF,28,POR,56,56,1633,175,402,0.435,71,200,0.355,104,202,0.515,0.524,103,122,0.844,85,358,443,71,50,21,46,107,524
14,Justin Anderson\anderju01,SF,25,ATL,29,0,238,31,81,0.383,8,39,0.205,23,42,0.548,0.432,16,21,0.762,11,33,44,12,11,7,13,26,86
15,Kyle Anderson\anderky01,SF,25,MEM,43,40,1281,150,276,0.543,9,34,0.265,141,242,0.583,0.56,37,64,0.578,48,203,251,128,54,37,58,112,346
16,Ryan Anderson\anderry01,PF,30,TOT,16,8,280,19,60,0.317,7,34,0.206,12,26,0.462,0.375,11,14,0.786,14,31,45,18,3,1,12,23,56
17,Ike Anigbogu\anigbik01,C,20,IND,3,0,6,0,3,0,0,0,,0,3,0,0,0,0,,1,2,3,1,0,1,1,0,0
18,Giannis Antetokounmpo\antetgi01,PF,24,MIL,52,52,1719,519,892,0.582,29,128,0.227,490,764,0.641,0.598,340,477,0.713,117,537,654,306,73,75,202,179,1407
19,Carmelo Anthony\anthoca01,PF,34,HOU,10,2,294,49,121,0.405,21,64,0.328,28,57,0.491,0.492,15,22,0.682,9,45,54,5,4,7,8,32,134
20,OG Anunoby\anunoog01,SF,21,TOR,47,5,940,127,293,0.433,48,148,0.324,79,145,0.545,0.515,19,42,0.452,37,105,142,33,31,11,34,101,321
21,Ryan Arcidiacono\arcidry01,PG,24,CHI,56,24,1368,106,256,0.414,61,169,0.361,45,87,0.517,0.533,47,52,0.904,14,116,130,193,53,2,45,117,320
22,Trevor Ariza\arizatr01,SF,33,TOT,53,53,1878,230,581,0.396,115,343,0.335,115,238,0.483,0.495,94,118,0.797,35,258,293,201,81,13,87,103,669
23,D.J. Augustin\augusdj01,PG,31,ORL,57,57,1583,208,447,0.465,90,213,0.423,118,234,0.504,0.566,145,166,0.873,28,96,124,277,33,0,87,82,651
24,Deandre Ayton\aytonde01,C,20,PHO,52,51,1610,377,642,0.587,0,4,0,377,638,0.591,0.587,103,133,0.774,164,384,548,102,42,49,96,149,857
25,Dwayne Bacon\bacondw01,SG,23,CHO,24,0,256,44,83,0.53,13,24,0.542,31,59,0.525,0.608,10,12,0.833,3,36,39,17,3,1,12,27,111
26,Marvin Bagley\baglema01,PF,19,SAC,42,1,1017,217,422,0.514,13,53,0.245,204,369,0.553,0.53,113,164,0.689,100,193,293,40,23,42,70,88,560
27,Ron Baker\bakerro01,SG,25,TOT,15,0,152,4,20,0.2,1,13,0.077,3,7,0.429,0.225,5,6,0.833,1,10,11,15,6,1,5,18,14
28,Wade Baldwin\baldwwa01,PG,22,POR,16,0,94,10,33,0.303,2,9,0.222,8,24,0.333,0.333,8,11,0.727,2,13,15,12,1,2,14,11,30
29,Lonzo Ball\balllo01,PG,21,LAL,47,45,1423,185,456,0.406,75,228,0.329,110,228,0.482,0.488,20,48,0.417,54,197,251,255,69,19,103,114,465
30,Mohamed Bamba\bambamo01,C,20,ORL,47,1,766,117,243,0.481,21,70,0.3,96,173,0.555,0.525,37,63,0.587,64,169,233,39,13,64,43,102,292
31,J.J. Barea\bareajo01,PG,34,DAL,38,0,752,161,385,0.418,38,128,0.297,123,257,0.479,0.468,55,78,0.705,13,82,95,211,22,1,72,50,415
32,Harrison Barnes\barneha02,PF-SF,26,TOT,51,51,1651,296,735,0.403,124,322,0.385,172,413,0.416,0.487,171,204,0.838,37,181,218,67,35,11,72,83,887
33,Will Barton\bartowi01,SG,28,DEN,17,12,447,75,181,0.414,27,73,0.37,48,108,0.444,0.489,27,34,0.794,17,60,77,60,5,10,24,36,204
34,Keita Bates-Diop\bateske01,SF,23,MIN,6,0,34,3,11,0.273,0,5,0,3,6,0.5,0.273,0,2,0,0,6,6,0,0,1,1,2,6
35,Nicolas Batum\batumni01,SF,30,CHO,56,56,1753,190,413,0.46,81,208,0.389,109,205,0.532,0.558,59,69,0.855,50,240,290,189,54,30,89,99,520
36,Jerryd Bayless\bayleje01,PG,30,MIN,18,6,391,47,141,0.333,23,70,0.329,24,71,0.338,0.415,7,12,0.583,7,31,38,74,10,1,19,32,124
37,Aron Baynes\baynear01,C,32,BOS,34,10,507,69,148,0.466,16,48,0.333,53,100,0.53,0.52,39,46,0.848,60,87,147,38,6,22,28,82,193
38,Kent Bazemore\bazemke01,SG,29,ATL,43,30,1095,202,462,0.437,61,189,0.323,141,273,0.516,0.503,93,128,0.727,22,139,161,107,69,36,87,111,558
39,Bradley Beal\bealbr01,SG,25,WAS,57,57,2114,529,1119,0.473,143,409,0.35,386,710,0.544,0.537,229,283,0.809,65,226,291,300,81,43,161,170,1430
40,Malik Beasley\beaslma01,SG,22,DEN,56,13,1340,254,503,0.505,117,268,0.437,137,235,0.583,0.621,36,41,0.878,22,117,139,68,37,6,34,88,661
41,Michael Beasley\beaslmi01,PF,30,LAL,26,2,277,75,153,0.49,3,17,0.176,72,136,0.529,0.5,28,39,0.718,13,47,60,25,9,10,27,42,181
42,Marco Belinelli\belinma01,SG,32,SAS,57,1,1295,210,502,0.418,111,288,0.385,99,214,0.463,0.529,92,100,0.92,11,121,132,109,28,8,50,91,623
43,Jordan Bell\belljo01,C,24,GSW,47,2,514,61,117,0.521,0,1,0,61,116,0.526,0.521,14,21,0.667,34,83,117,55,16,35,23,56,136
44,DeAndre' Bembry\bembrde01,SG,24,ATL,57,15,1391,185,430,0.43,37,128,0.289,148,302,0.49,0.473,55,89,0.618,31,205,236,145,71,30,100,136,462
45,Dragan Bender\bendedr01,PF,21,PHO,23,7,289,34,83,0.41,7,44,0.159,27,39,0.692,0.452,16,24,0.667,16,51,67,21,5,3,15,28,91
46,Davis Bertans\bertada01,PF,26,SAS,53,10,1130,148,305,0.485,109,229,0.476,39,76,0.513,0.664,35,40,0.875,18,166,184,66,28,26,32,91,440
47,Patrick Beverley\beverpa01,PG,30,LAC,58,29,1558,135,338,0.399,77,199,0.387,58,139,0.417,0.513,80,103,0.777,49,222,271,207,43,30,60,199,427
48,Khem Birch\birchkh01,C,26,ORL,26,0,276,32,57,0.561,0,1,0,32,56,0.571,0.561,23,28,0.821,27,56,83,17,9,17,8,26,87
49,Bismack Biyombo\biyombi01,C,26,CHO,31,17,470,51,90,0.567,0,0,,51,90,0.567,0.567,35,54,0.648,47,103,150,18,8,34,18,63,137
50,Nemanja Bjelica\bjeline01,PF,30,SAC,55,54,1287,206,430,0.479,78,187,0.417,128,243,0.527,0.57,52,67,0.776,91,229,320,106,40,45,68,140,542
51,Antonio Blakeney\blakean01,SG,22,CHI,41,0,579,120,284,0.423,32,70,0.457,88,214,0.411,0.479,38,56,0.679,6,59,65,22,10,8,25,26,310
52,Eric Bledsoe\bledser01,PG,29,MIL,55,55,1609,338,685,0.493,87,269,0.323,251,416,0.603,0.557,119,154,0.773,55,196,251,302,83,22,114,119,882
53,Jaron Blossomgame\blossja01,SF,25,CLE,27,4,439,47,106,0.443,10,39,0.256,37,67,0.552,0.491,10,13,0.769,26,72,98,13,7,8,11,20,114
54,Bogdan Bogdanovic\bogdabo01,SG,26,SAC,44,9,1231,242,569,0.425,81,242,0.335,161,327,0.492,0.496,87,109,0.798,20,138,158,178,48,9,80,87,652
55,Bojan Bogdanovic\bogdabo02,SF,29,IND,57,57,1813,343,694,0.494,114,266,0.429,229,428,0.535,0.576,154,186,0.828,28,197,225,101,47,0,90,97,954
56,Jonah Bolden\boldejo01,PF,23,PHI,28,3,350,41,84,0.488,15,47,0.319,26,37,0.703,0.577,8,18,0.444,25,73,98,17,8,24,23,59,105
57,Isaac Bonga\bongais01,PG,19,LAL,8,0,31,2,10,0.2,0,2,0,2,8,0.25,0.2,4,7,0.571,3,3,6,6,3,0,2,3,8
58,Devin Booker\bookede01,SG,22,PHO,43,43,1496,379,818,0.463,91,277,0.329,288,541,0.532,0.519,222,263,0.844,25,143,168,288,38,7,168,140,1071
59,Chris Boucher\bouchch01,PF,26,TOR,16,0,89,21,46,0.457,9,23,0.391,12,23,0.522,0.554,11,13,0.846,11,17,28,0,3,16,2,16,62
60,Avery Bradley\bradlav01,SG,28,TOT,51,51,1526,179,451,0.397,63,181,0.348,116,270,0.43,0.467,20,25,0.8,35,103,138,104,29,16,66,137,441
61,Tony Bradley\bradlto01,C,21,UTA,1,0,9,0,3,0,0,0,,0,3,0,0,0,0,,2,1,3,0,0,0,1,1,0
62,Corey Brewer\breweco01,SF,32,PHI,7,3,140,20,49,0.408,4,14,0.286,16,35,0.457,0.449,9,13,0.692,4,13,17,10,12,2,8,16,53
63,Mikal Bridges\bridgmi01,SF,22,PHO,58,44,1617,171,393,0.435,81,227,0.357,90,166,0.542,0.538,56,71,0.789,38,143,181,102,90,30,47,141,479
64,Miles Bridges\bridgmi02,SF,20,CHO,54,0,1021,135,303,0.446,38,122,0.311,97,181,0.536,0.508,43,59,0.729,31,158,189,54,28,34,31,67,351
65,Isaiah Briscoe\briscis01,PG,22,ORL,33,0,428,40,104,0.385,8,25,0.32,32,79,0.405,0.423,9,18,0.5,2,50,52,70,8,1,23,51,97
66,Ryan Broekhoff\broekry01,SG,28,DAL,25,0,201,26,60,0.433,17,46,0.37,9,14,0.643,0.575,2,2,1,3,22,25,13,2,3,5,13,71
67,Malcolm Brogdon\brogdma01,SG,26,MIL,52,52,1518,311,616,0.505,79,192,0.411,232,424,0.547,0.569,117,124,0.944,54,193,247,172,38,12,80,85,818
68,Dillon Brooks\brookdi01,SF,23,MEM,18,0,330,49,122,0.402,15,40,0.375,34,82,0.415,0.463,22,30,0.733,9,22,31,16,10,4,19,50,135
69,MarShon Brooks\brookma01,SG,30,MEM,29,0,387,76,169,0.45,15,54,0.278,61,115,0.53,0.494,23,33,0.697,12,33,45,25,9,4,21,33,190
70,Bruce Brown\brownbr01,SG,22,DET,48,30,957,88,228,0.386,18,68,0.265,70,160,0.438,0.425,31,45,0.689,33,99,132,63,21,23,34,121,225
71,Jaylen Brown\brownja02,SG,22,BOS,52,23,1346,250,558,0.448,61,192,0.318,189,366,0.516,0.503,96,141,0.681,53,167,220,71,47,26,71,135,657
72,Lorenzo Brown\brownlo01,PG,28,TOR,26,0,212,23,71,0.324,6,28,0.214,17,43,0.395,0.366,3,3,1,5,26,31,28,12,5,16,22,55
73,Sterling Brown\brownst02,SG,23,MIL,45,0,730,95,210,0.452,40,110,0.364,55,100,0.55,0.548,17,23,0.739,24,107,131,58,17,5,30,62,247
74,Troy Brown\browntr01,SF,19,WAS,29,0,208,26,65,0.4,4,15,0.267,22,50,0.44,0.431,14,21,0.667,5,34,39,27,8,1,8,16,70
75,Jalen Brunson\brunsja01,PG,22,DAL,48,16,864,127,294,0.432,31,88,0.352,96,206,0.466,0.485,40,60,0.667,13,83,96,115,23,2,47,68,325
76,Thomas Bryant\bryanth01,C,21,WAS,47,41,897,187,290,0.645,16,43,0.372,171,247,0.692,0.672,61,74,0.824,67,203,270,54,16,37,33,71,451
77,Reggie Bullock\bullore01,SG,27,TOT,46,46,1421,189,457,0.414,117,302,0.387,72,155,0.465,0.542,56,64,0.875,20,109,129,113,27,8,55,82,551
78,Trey Burke\burketr01,PG,26,TOT,37,7,757,159,381,0.417,35,95,0.368,124,286,0.434,0.463,69,83,0.831,17,52,69,104,25,5,36,39,422
79,Alec Burks\burksal01,SG,27,TOT,53,24,1284,187,460,0.407,61,163,0.374,126,297,0.424,0.473,113,137,0.825,29,191,220,119,32,20,61,84,548
80,Deonte Burton\burtode02,SG,25,OKC,19,0,173,27,57,0.474,7,19,0.368,20,38,0.526,0.535,6,8,0.75,3,17,20,6,3,8,7,22,67
81,Jimmy Butler\butleji01,SF-SG,29,TOT,45,45,1505,306,637,0.48,56,151,0.371,250,486,0.514,0.524,209,244,0.857,76,150,226,172,91,25,63,79,877
82,Bruno Caboclo\cabocbr01,SF,23,MEM,10,1,211,19,57,0.333,9,36,0.25,10,21,0.476,0.412,14,14,1,9,23,32,8,5,14,9,27,61
83,Jose Calderon\caldejo01,PG,37,DET,46,0,621,45,118,0.381,14,56,0.25,31,62,0.5,0.441,9,11,0.818,9,47,56,113,16,3,35,63,113
84,Kentavious Caldwell-Pope\caldwke01,SG,25,LAL,57,12,1368,201,464,0.433,93,267,0.348,108,197,0.548,0.533,91,107,0.85,33,124,157,63,49,8,39,88,586
85,Isaiah Canaan\canaais01,PG,27,TOT,25,16,592,61,157,0.389,31,90,0.344,30,67,0.448,0.487,19,24,0.792,5,48,53,81,14,1,33,50,172
86,Clint Capela\capelca01,C,24,HOU,42,42,1436,315,499,0.631,0,0,,315,499,0.631,0.631,109,174,0.626,208,320,528,62,25,77,65,112,739
87,DeMarre Carroll\carrode01,SF,32,BRK,45,0,1135,151,391,0.386,69,204,0.338,82,187,0.439,0.474,127,171,0.743,45,185,230,61,24,6,51,72,498
88,Jevon Carter\carteje01,PG,23,MEM,24,3,366,25,104,0.24,13,55,0.236,12,49,0.245,0.303,7,11,0.636,4,27,31,42,19,8,21,37,70
89,Vince Carter\cartevi01,SF,42,ATL,52,8,826,122,287,0.425,74,191,0.387,48,96,0.5,0.554,24,35,0.686,22,113,135,51,30,17,34,92,342
90,Wendell Carter\cartewe01,C,19,CHI,44,44,1110,180,371,0.485,6,32,0.188,174,339,0.513,0.493,89,112,0.795,87,220,307,78,26,58,65,152,455
91,Michael Carter-Williams\cartemi01,PG,27,HOU,16,1,145,25,61,0.41,7,19,0.368,18,42,0.429,0.467,12,26,0.462,3,10,13,21,9,6,10,27,69
92,Alex Caruso\carusal01,PG,24,LAL,5,0,20,2,4,0.5,1,1,1,1,3,0.333,0.625,1,4,0.25,1,0,1,1,0,2,0,3,6
93,Omri Casspi\casspom01,SF,30,MEM,36,0,520,86,161,0.534,15,43,0.349,71,118,0.602,0.581,39,58,0.672,17,98,115,26,20,9,23,35,226
94,Willie Cauley-Stein\caulewi01,C,25,SAC,56,56,1579,305,566,0.539,1,2,0.5,304,564,0.539,0.54,105,194,0.541,135,343,478,145,67,39,68,169,716
95,Troy Caupain\caupatr01,PG,23,ORL,2,0,9,2,4,0.5,1,2,0.5,1,2,0.5,0.625,0,0,,0,2,2,3,1,0,0,0,5
96,Tyler Cavanaugh\cavanty01,PF,24,UTA,8,0,19,2,6,0.333,0,3,0,2,3,0.667,0.333,2,2,1,1,3,4,0,0,0,1,0,6
97,Tyson Chandler\chandty01,C,36,TOT,48,6,813,59,97,0.608,0,1,0,59,96,0.615,0.608,48,81,0.593,90,201,291,34,20,22,36,103,166
98,Wilson Chandler\chandwi01,PF,31,PHI,36,32,951,91,207,0.44,46,118,0.39,45,89,0.506,0.551,13,18,0.722,44,124,168,72,22,18,39,94,241
99,Joe Chealey\chealjo01,PG,23,CHO,1,0,8,1,3,0.333,0,0,,1,3,0.333,0.333,0,0,,0,0,0,1,0,0,0,1,2
100,Marquese Chriss\chrisma01,PF,21,TOT,19,1,173,24,59,0.407,7,25,0.28,17,34,0.5,0.466,8,9,0.889,10,36,46,9,4,4,16,24,63
101,Gary Clark\clarkga01,PF,24,HOU,37,1,528,35,110,0.318,29,100,0.29,6,10,0.6,0.45,6,6,1,18,76,94,14,15,22,5,38,105
102,Ian Clark\clarkia01,SG,27,NOP,40,0,533,70,177,0.395,31,90,0.344,39,87,0.448,0.483,14,15,0.933,6,45,51,48,7,4,36,53,185
103,Jordan Clarkson\clarkjo01,SG,26,CLE,56,0,1494,367,820,0.448,101,305,0.331,266,515,0.517,0.509,103,124,0.831,52,137,189,134,41,10,93,84,938
104,John Collins\collijo01,PF,21,ATL,41,39,1223,315,545,0.578,37,101,0.366,278,444,0.626,0.612,128,171,0.749,148,250,398,87,12,17,88,138,795
105,Zach Collins\colliza01,C,21,POR,56,0,1013,141,294,0.48,30,87,0.345,111,207,0.536,0.531,71,92,0.772,80,160,240,54,22,44,57,141,383
106,Darren Collison\collida01,PG,31,IND,57,57,1596,222,471,0.471,59,143,0.413,163,328,0.497,0.534,94,115,0.817,26,138,164,335,83,8,86,101,597
107,Mike Conley\conlemi01,PG,31,MEM,55,55,1849,375,875,0.429,119,334,0.356,256,541,0.473,0.497,236,278,0.849,34,156,190,353,78,18,104,94,1105
108,Pat Connaughton\connapa01,SG,26,MIL,37,1,626,84,192,0.438,32,111,0.288,52,81,0.642,0.521,15,22,0.682,28,93,121,68,16,15,18,40,215
109,Quinn Cook\cookqu01,PG,25,GSW,48,8,689,133,294,0.452,49,130,0.377,84,164,0.512,0.536,15,20,0.75,16,92,108,82,17,3,32,65,330
110,DeMarcus Cousins\couside01,C,28,GSW,11,11,257,50,118,0.424,9,31,0.29,41,87,0.471,0.462,44,60,0.733,13,62,75,41,14,12,23,40,153
111,Robert Covington\covinro01,SF,28,TOT,35,35,1203,156,362,0.431,85,225,0.378,71,137,0.518,0.548,68,89,0.764,28,165,193,46,74,47,47,126,465
112,Allen Crabbe\crabbal01,SG,26,BRK,31,15,798,102,278,0.367,77,189,0.407,25,89,0.281,0.505,30,38,0.789,13,88,101,34,20,8,34,73,311
113,Torrey Craig\craigto01,SF,28,DEN,51,37,1153,119,272,0.438,41,137,0.299,78,135,0.578,0.513,32,50,0.64,73,128,201,49,27,33,38,125,311
114,Jamal Crawford\crawfja01,SG,38,PHO,48,0,847,102,287,0.355,35,128,0.273,67,159,0.421,0.416,56,69,0.812,7,49,56,160,20,8,70,57,295
115,Mitch Creek\creekmi01,SF,26,BRK,4,0,36,5,10,0.5,0,1,0,5,9,0.556,0.5,5,7,0.714,5,5,10,5,1,0,0,3,15
116,Jae Crowder\crowdja01,SF,28,UTA,56,8,1536,218,555,0.393,122,366,0.333,96,189,0.508,0.503,105,152,0.691,45,219,264,91,44,21,65,118,663
117,Dante Cunningham\cunnida01,PF,31,SAS,53,21,845,71,142,0.5,30,60,0.5,41,82,0.5,0.606,13,16,0.813,45,133,178,48,23,13,21,66,185
118,Seth Curry\curryse01,SG,28,POR,50,2,859,115,261,0.441,66,139,0.475,49,122,0.402,0.567,10,10,1,15,55,70,48,19,7,35,68,306
119,Stephen Curry\curryst01,PG,30,GSW,45,45,1543,430,877,0.49,231,517,0.447,199,360,0.553,0.622,193,210,0.919,31,198,229,238,56,18,127,116,1284
120,Troy Daniels\danietr01,SG,27,PHO,28,0,370,53,132,0.402,39,99,0.394,14,33,0.424,0.549,12,15,0.8,6,24,30,9,16,2,18,36,157
121,Anthony Davis\davisan02,C,25,NOP,44,44,1602,446,878,0.508,40,125,0.32,406,753,0.539,0.531,320,395,0.81,142,434,576,187,72,113,86,115,1252
122,Ed Davis\davised01,C,29,BRK,57,1,1040,136,219,0.621,0,2,0,136,217,0.627,0.621,64,109,0.587,159,333,492,47,28,24,48,160,336
123,Tyler Davis\davisty01,C,21,OKC,1,0,1,0,1,0,0,0,,0,1,0,0,0,0,,1,0,1,0,0,0,0,0,0
124,Dewayne Dedmon\dedmode01,C,29,ATL,47,36,1163,182,375,0.485,59,155,0.381,123,220,0.559,0.564,63,74,0.851,73,262,335,63,46,46,67,157,486
125,Sam Dekker\dekkesa01,SF-PF,24,TOT,35,5,598,99,199,0.497,13,42,0.31,86,157,0.548,0.53,18,30,0.6,41,80,121,33,31,7,17,36,229
126,Angel Delgado\delgaan01,C,24,LAC,1,0,14,1,4,0.25,0,0,,1,4,0.25,0.25,1,2,0.5,2,2,4,0,1,0,0,2,3
127,Matthew Dellavedova\dellama01,PG,28,TOT,40,0,641,85,198,0.429,39,109,0.358,46,89,0.517,0.528,34,42,0.81,5,56,61,135,8,0,58,61,243
128,Luol Deng\denglu01,SF,33,MIN,17,1,275,45,89,0.506,11,33,0.333,34,56,0.607,0.567,17,23,0.739,16,40,56,9,11,4,8,15,118
129,DeMar DeRozan\derozde01,SG,29,SAS,54,54,1906,447,966,0.463,7,41,0.171,440,925,0.476,0.466,254,309,0.822,42,289,331,331,54,26,142,123,1155
130,Marcus Derrickson\derrima01,PF,22,GSW,9,0,54,10,24,0.417,5,14,0.357,5,10,0.5,0.521,3,4,0.75,5,3,8,1,0,1,3,9,28
131,Cheick Diallo\diallch01,PF,22,NOP,40,0,441,74,124,0.597,0,2,0,74,122,0.607,0.597,29,42,0.69,38,113,151,13,15,21,25,53,177
132,Hamidou Diallo\diallha01,SG,20,OKC,45,3,515,75,161,0.466,4,23,0.174,71,138,0.514,0.478,36,59,0.61,37,57,94,17,20,10,23,75,190
133,Gorgui Dieng\dienggo01,C,29,MIN,56,0,760,124,251,0.494,13,42,0.31,111,209,0.531,0.52,58,66,0.879,59,173,232,50,31,29,34,107,319
134,Spencer Dinwiddie\dinwisp01,PG,25,BRK,49,4,1399,275,596,0.461,96,262,0.366,179,334,0.536,0.542,198,249,0.795,21,100,121,246,28,11,114,136,844
135,Donte DiVincenzo\divindo01,SG,22,MIL,23,0,358,42,107,0.393,17,69,0.246,25,38,0.658,0.472,9,11,0.818,13,43,56,27,12,6,18,34,110
136,Luka Doncic\doncilu01,SG,19,DAL,54,54,1739,372,860,0.433,131,376,0.348,241,484,0.498,0.509,247,342,0.722,56,327,383,298,57,15,172,101,1122
137,Tyler Dorsey\dorsety01,SG,22,ATL,27,0,251,32,89,0.36,10,39,0.256,22,50,0.44,0.416,16,26,0.615,9,34,43,17,7,1,10,20,90
138,Damyean Dotson\dotsoda01,SG,24,NYK,47,15,1160,162,381,0.425,65,172,0.378,97,209,0.464,0.51,39,57,0.684,26,137,163,65,41,5,34,85,428
139,PJ Dozier\doziepj01,SG,22,BOS,4,0,10,3,6,0.5,1,2,0.5,2,4,0.5,0.583,0,0,,2,2,4,0,0,0,0,1,7
140,Goran Dragic\dragigo01,PG,32,MIA,14,14,408,77,188,0.41,22,70,0.314,55,118,0.466,0.468,38,50,0.76,8,35,43,68,10,4,35,30,214
141,Andre Drummond\drumman01,C,25,DET,52,52,1713,378,719,0.526,4,33,0.121,374,686,0.545,0.529,142,254,0.559,267,511,778,62,82,91,121,175,902
142,Jared Dudley\dudleja01,PF,33,BRK,43,25,944,77,190,0.405,39,121,0.322,38,69,0.551,0.508,22,35,0.629,25,95,120,65,28,13,37,105,215
143,Kris Dunn\dunnkr01,PG,24,CHI,31,29,970,152,350,0.434,19,56,0.339,133,294,0.452,0.461,40,51,0.784,9,122,131,200,46,16,79,113,363
144,Kevin Durant\duranke01,PF,30,GSW,56,56,1984,542,1057,0.513,102,282,0.362,440,775,0.568,0.561,355,397,0.894,28,366,394,334,45,59,175,107,1541
145,Trevon Duval\duvaltr01,PG,20,MIL,3,0,6,2,3,0.667,1,1,1,1,2,0.5,0.833,0,0,,0,1,1,2,0,0,0,0,5
146,Vince Edwards\edwarvi01,SF,22,HOU,2,0,16,1,4,0.25,1,4,0.25,0,0,,0.375,0,0,,1,1,2,0,0,0,0,0,3
147,Henry Ellenson\ellenhe01,PF,22,DET,2,0,25,4,10,0.4,2,4,0.5,2,6,0.333,0.5,2,2,1,0,9,9,1,0,0,0,2,12
148,Wayne Ellington\ellinwa01,SG,31,TOT,26,12,552,70,192,0.365,57,162,0.352,13,30,0.433,0.513,14,16,0.875,6,45,51,31,24,3,16,43,211
149,Joel Embiid\embiijo01,C,24,PHI,53,53,1788,476,989,0.481,64,217,0.295,412,772,0.534,0.514,431,532,0.81,132,582,714,185,32,104,190,177,1447
150,James Ennis\ennisja01,SF,28,TOT,42,25,981,106,219,0.484,46,124,0.371,60,95,0.632,0.589,42,58,0.724,37,85,122,29,39,16,23,115,300
151,Drew Eubanks\eubandr01,PF,21,SAS,15,0,73,14,19,0.737,0,0,,14,19,0.737,0.737,9,11,0.818,1,15,16,3,1,2,4,7,37
152,Jacob Evans\evansja02,SG,21,GSW,23,0,99,6,25,0.24,1,6,0.167,5,19,0.263,0.26,0,1,0,1,8,9,13,1,1,6,13,13
153,Jawun Evans\evansja01,PG,22,PHO,6,0,62,3,13,0.231,0,2,0,3,11,0.273,0.231,0,0,,1,11,12,10,3,0,5,8,6
154,Tyreke Evans\evansty01,SG,29,IND,50,15,1021,188,481,0.391,59,165,0.358,129,316,0.408,0.452,85,110,0.773,26,114,140,121,48,12,88,83,520
155,Dante Exum\exumda01,PG,23,UTA,39,1,637,101,234,0.432,18,59,0.305,83,175,0.474,0.47,68,86,0.791,15,50,65,107,14,5,46,63,288
156,Kenneth Faried\farieke01,C,29,TOT,23,10,450,100,158,0.633,3,11,0.273,97,147,0.66,0.642,37,64,0.578,56,100,156,14,11,16,23,48,240
157,Derrick Favors\favorde01,C,27,UTA,56,50,1292,247,434,0.569,14,62,0.226,233,372,0.626,0.585,109,167,0.653,147,248,395,59,42,75,59,121,617
158,Cristiano Felicio\feliccr01,C,26,CHI,35,0,353,43,78,0.551,0,2,0,43,76,0.566,0.551,21,30,0.7,33,64,97,18,5,4,16,30,107
159,Raymond Felton\feltora01,PG,34,OKC,16,0,187,34,86,0.395,9,35,0.257,25,51,0.49,0.448,8,9,0.889,3,19,22,28,8,4,11,15,85
160,Terrance Ferguson\fergute01,SG,20,OKC,48,48,1161,121,273,0.443,67,173,0.387,54,100,0.54,0.566,17,26,0.654,22,65,87,38,28,11,26,149,326
161,Yogi Ferrell\ferreyo01,PG,25,SAC,46,3,692,103,228,0.452,37,96,0.385,66,132,0.5,0.533,36,41,0.878,10,63,73,94,23,4,20,37,279
162,Dorian Finney-Smith\finnedo01,SF,25,DAL,56,17,1411,166,358,0.464,59,170,0.347,107,188,0.569,0.546,50,74,0.676,101,164,265,48,56,27,56,132,441
163,Bryn Forbes\forbebr01,PG,25,SAS,59,58,1684,264,592,0.446,127,303,0.419,137,289,0.474,0.553,54,60,0.9,12,159,171,127,37,3,67,126,709
164,Evan Fournier\fournev01,SG,26,ORL,57,57,1797,324,753,0.43,110,322,0.342,214,431,0.497,0.503,97,122,0.795,29,147,176,206,50,8,115,165,855
165,De'Aaron Fox\foxde01,PG,21,SAC,55,55,1728,340,739,0.46,59,162,0.364,281,577,0.487,0.5,207,284,0.729,33,170,203,391,95,28,165,139,946
166,Melvin Frazier\frazime01,SG,22,ORL,6,0,27,4,11,0.364,0,2,0,4,9,0.444,0.364,0,0,,2,1,3,0,1,0,1,4,8
167,Tim Frazier\fraziti01,PG,28,NOP,46,17,902,88,194,0.454,27,77,0.351,61,117,0.521,0.523,32,41,0.78,32,105,137,204,25,4,59,93,235
168,Channing Frye\fryech01,C,35,CLE,29,5,275,32,89,0.36,24,60,0.4,8,29,0.276,0.494,9,12,0.75,4,39,43,16,5,4,10,35,97
169,Markelle Fultz\fultzma01,PG,20,PHI,19,15,427,65,155,0.419,4,14,0.286,61,141,0.433,0.432,21,37,0.568,26,44,70,59,17,5,25,52,155
170,Danilo Gallinari\gallida01,SF,30,LAC,47,47,1452,265,594,0.446,114,259,0.44,151,335,0.451,0.542,235,259,0.907,40,242,282,117,33,14,66,96,879
171,Langston Galloway\gallola01,SG,27,DET,53,4,1137,144,385,0.374,83,253,0.328,61,132,0.462,0.482,46,57,0.807,33,92,125,57,25,5,18,84,417
172,Marc Gasol\gasolma01,C,34,TOT,55,53,1829,313,699,0.448,77,222,0.347,236,477,0.495,0.503,154,205,0.751,57,410,467,251,63,65,123,150,857
173,Pau Gasol\gasolpa01,C,38,SAS,26,6,324,41,86,0.477,5,10,0.5,36,76,0.474,0.506,27,38,0.711,20,102,122,49,5,14,14,27,114
174,Rudy Gay\gayru01,PF,32,SAS,48,45,1311,277,534,0.519,54,124,0.435,223,410,0.544,0.569,86,100,0.86,45,265,310,127,41,29,81,125,694
175,Paul George\georgpa01,SF,28,OKC,55,55,1993,518,1140,0.454,215,520,0.413,303,620,0.489,0.549,326,390,0.836,79,362,441,226,127,25,144,155,1577
176,Taj Gibson\gibsota01,PF,33,MIN,55,54,1379,233,414,0.563,11,33,0.333,222,381,0.583,0.576,96,129,0.744,134,222,356,64,45,32,59,146,573
177,Harry Giles\gilesha01,PF,20,SAC,43,0,555,116,234,0.496,0,5,0,116,229,0.507,0.496,35,59,0.593,43,105,148,56,26,14,53,107,267
178,Shai Gilgeous-Alexander\gilgesh01,PG,20,LAC,58,49,1502,225,482,0.467,30,90,0.333,195,392,0.497,0.498,106,130,0.815,41,116,157,175,61,33,107,119,586
179,Rudy Gobert\goberru01,C,26,UTA,57,56,1800,320,489,0.654,0,0,,320,489,0.654,0.654,226,344,0.657,214,519,733,127,52,122,90,158,866
180,Brandon Goodwin\goodwbr01,PG,23,DEN,16,0,57,6,23,0.261,2,6,0.333,4,17,0.235,0.304,9,11,0.818,1,2,3,14,0,0,3,7,23
181,Aaron Gordon\gordoaa01,PF,23,ORL,54,54,1809,320,710,0.451,82,237,0.346,238,473,0.503,0.508,135,185,0.73,90,301,391,191,41,36,107,126,857
182,Eric Gordon\gordoer01,SG,30,HOU,44,30,1422,250,638,0.392,120,376,0.319,130,262,0.496,0.486,93,118,0.788,15,97,112,86,23,19,64,101,713
183,Marcin Gortat\gortama01,C,34,LAC,47,43,751,99,186,0.532,0,0,,99,186,0.532,0.532,35,48,0.729,67,194,261,65,6,24,50,92,233
184,Devonte' Graham\grahade01,PG,23,CHO,30,3,381,47,125,0.376,23,71,0.324,24,54,0.444,0.468,16,22,0.727,3,32,35,64,17,0,20,31,133
185,Treveon Graham\grahatr01,SG,25,BRK,20,14,455,37,111,0.333,20,72,0.278,17,39,0.436,0.423,14,18,0.778,14,46,60,21,8,5,14,51,108
186,Jerami Grant\grantje01,PF,24,OKC,55,52,1774,272,523,0.52,63,169,0.373,209,354,0.59,0.58,112,163,0.687,57,223,280,51,50,75,47,144,719
187,Jerian Grant\grantje02,PG,26,ORL,47,1,786,70,178,0.393,28,87,0.322,42,91,0.462,0.472,21,31,0.677,16,66,82,131,38,4,45,66,189
188,Donte Grantham\grantdo01,SF,23,OKC,1,0,2,0,1,0,0,1,0,0,0,,0,0,0,,0,0,0,0,0,0,0,0,0
189,Danny Green\greenda02,SG,31,TOR,56,56,1609,199,447,0.445,126,300,0.42,73,147,0.497,0.586,26,29,0.897,48,183,231,79,51,43,52,130,550
190,Draymond Green\greendr01,PF,28,GSW,41,41,1275,111,264,0.42,23,99,0.232,88,165,0.533,0.464,42,58,0.724,40,273,313,300,66,42,105,130,287
191,Gerald Green\greenge01,SG,33,HOU,52,0,1104,176,422,0.417,116,324,0.358,60,98,0.612,0.555,39,49,0.796,24,116,140,30,18,21,36,99,507
192,JaMychal Green\greenja01,PF,28,TOT,43,4,935,156,318,0.491,41,100,0.41,115,218,0.528,0.555,63,80,0.788,74,189,263,36,34,26,66,131,416
193,Jeff Green\greenje02,PF,32,WAS,55,29,1519,234,495,0.473,84,228,0.368,150,267,0.562,0.558,124,138,0.899,50,195,245,112,26,29,73,119,676
194,Blake Griffin\griffbl01,PF,29,DET,53,53,1922,470,983,0.478,130,359,0.362,340,624,0.545,0.544,316,415,0.761,71,358,429,287,39,22,200,152,1386
195,Daniel Hamilton\hamilda02,SG,23,ATL,19,3,204,23,60,0.383,8,23,0.348,15,37,0.405,0.45,3,6,0.5,10,37,47,22,6,1,16,19,57
196,Tim Hardaway\hardati02,SG,26,TOT,50,49,1613,304,783,0.388,124,364,0.341,180,419,0.43,0.467,206,242,0.851,29,146,175,129,44,7,86,110,938
197,James Harden\hardeja01,SG,29,HOU,53,53,1980,566,1282,0.441,266,711,0.374,300,571,0.525,0.545,536,616,0.87,51,304,355,411,117,41,284,174,1934
198,Maurice Harkless\harklma01,SF,25,POR,36,29,771,86,188,0.457,19,66,0.288,67,122,0.549,0.508,20,30,0.667,38,97,135,28,33,31,26,101,211
199,Montrezl Harrell\harremo01,C,25,LAC,58,4,1534,370,593,0.624,1,8,0.125,369,585,0.631,0.625,178,289,0.616,137,252,389,102,54,82,84,181,919
200,Devin Harris\harride01,PG,35,DAL,44,0,655,90,220,0.409,39,125,0.312,51,95,0.537,0.498,55,74,0.743,7,59,66,58,27,10,34,76,274
201,Gary Harris\harriga01,SG,24,DEN,32,27,956,174,409,0.425,50,159,0.314,124,250,0.496,0.487,75,92,0.815,22,75,97,87,31,14,39,68,473
202,Joe Harris\harrijo01,SG,27,BRK,53,53,1577,263,531,0.495,128,275,0.465,135,256,0.527,0.616,69,81,0.852,35,158,193,138,28,9,84,139,723
203,Tobias Harris\harrito02,PF-SF,26,TOT,58,58,1999,443,895,0.495,117,272,0.43,326,623,0.523,0.56,195,223,0.874,40,414,454,161,41,25,111,132,1198
204,Andrew Harrison\harrian01,SG-PG,24,TOT,17,0,187,16,53,0.302,5,25,0.2,11,28,0.393,0.349,17,18,0.944,6,14,20,24,4,2,12,34,54
205,Shaquille Harrison\harrish01,PG,25,CHI,48,0,826,92,238,0.387,17,63,0.27,75,175,0.429,0.422,48,77,0.623,15,108,123,82,57,18,36,76,249
206,Josh Hart\hartjo01,SG,23,LAL,54,21,1425,164,402,0.408,81,239,0.339,83,163,0.509,0.509,49,72,0.681,29,184,213,81,56,35,53,124,458
207,Isaiah Hartenstein\harteis01,PF,20,HOU,27,0,220,20,41,0.488,2,6,0.333,18,35,0.514,0.512,11,14,0.786,21,26,47,14,7,12,13,56,53
208,Udonis Haslem\hasleud01,C,38,MIA,4,0,15,2,6,0.333,0,2,0,2,4,0.5,0.333,0,0,,1,5,6,0,0,0,2,3,4
209,Gordon Hayward\haywago01,PF,28,BOS,52,16,1345,205,471,0.435,63,187,0.337,142,284,0.5,0.502,102,120,0.85,43,196,239,177,50,16,78,76,575
210,John Henson\hensojo01,C,28,MIL,14,0,188,31,67,0.463,11,31,0.355,20,36,0.556,0.545,6,10,0.6,16,55,71,14,7,11,12,16,79
211,Juan Hernangomez\hernaju01,PF,23,DEN,54,25,1217,133,290,0.459,64,164,0.39,69,126,0.548,0.569,63,81,0.778,62,182,244,46,24,22,33,75,393
212,Willy Hernangomez\hernawi01,C,24,CHO,44,2,607,120,231,0.519,13,30,0.433,107,201,0.532,0.548,71,105,0.676,90,154,244,40,11,15,45,79,324
213,Mario Hezonja\hezonma01,SF,23,NYK,47,13,910,140,350,0.4,33,119,0.277,107,231,0.463,0.447,54,77,0.701,20,156,176,48,45,6,56,83,367
214,Isaiah Hicks\hicksis01,PF,24,NYK,1,0,4,0,0,,0,0,,0,0,,,1,2,0.5,0,0,0,1,0,0,0,0,1
215,Buddy Hield\hieldbu01,SG,26,SAC,56,56,1768,425,890,0.478,193,427,0.452,232,463,0.501,0.586,100,117,0.855,73,214,287,129,28,21,105,138,1143
216,Haywood Highsmith\highsha01,SF,22,PHI,2,0,9,1,2,0.5,1,2,0.5,0,0,,0.75,0,0,,0,1,1,2,0,0,0,0,3
217,Nene Hilario\hilarne01,C,36,HOU,27,2,364,41,74,0.554,0,2,0,41,72,0.569,0.554,22,31,0.71,20,64,84,19,12,10,6,58,104
218,George Hill\hillge01,PG,32,TOT,44,13,992,120,269,0.446,36,107,0.336,84,162,0.519,0.513,46,56,0.821,29,78,107,103,42,7,37,80,322
219,Solomon Hill\hillso01,SF,27,NOP,35,15,712,50,129,0.388,20,70,0.286,30,59,0.508,0.465,19,27,0.704,30,78,108,44,18,8,23,61,139
220,Aaron Holiday\holidaa01,PG,22,IND,37,0,438,73,191,0.382,28,95,0.295,45,96,0.469,0.455,30,34,0.882,4,50,54,56,15,12,26,47,204
221,Jrue Holiday\holidjr01,SG,28,NOP,58,58,2106,466,990,0.471,95,300,0.317,371,690,0.538,0.519,183,240,0.763,71,223,294,462,92,48,185,129,1210
222,Justin Holiday\holidju01,SG,29,TOT,58,53,1902,212,568,0.373,122,352,0.347,90,216,0.417,0.481,64,72,0.889,28,218,246,119,86,27,79,111,610
223,John Holland\hollajo02,SF,30,CLE,1,0,1,0,0,,0,0,,0,0,,,0,0,,0,0,0,0,0,0,0,0,0
224,Rondae Hollis-Jefferson\holliro01,SF,24,BRK,47,20,1046,161,401,0.401,9,43,0.209,152,358,0.425,0.413,99,154,0.643,64,189,253,80,32,23,52,92,430
225,Richaun Holmes\holmeri01,C,25,PHO,52,2,855,167,255,0.655,0,0,,167,255,0.655,0.655,90,125,0.72,87,149,236,43,30,59,39,140,424
226,Rodney Hood\hoodro01,SG,26,TOT,48,45,1300,207,473,0.438,60,161,0.373,147,312,0.471,0.501,104,114,0.912,18,98,116,93,40,5,36,106,578
227,Al Horford\horfoal01,C,32,BOS,47,47,1339,252,477,0.528,52,144,0.361,200,333,0.601,0.583,38,48,0.792,88,224,312,183,42,69,76,92,594
228,Danuel House\houseda01,SF,25,HOU,25,12,620,71,155,0.458,39,100,0.39,32,55,0.582,0.584,45,55,0.818,20,69,89,26,14,10,23,45,226
229,Dwight Howard\howardw01,C,33,WAS,9,9,230,43,69,0.623,0,0,,43,69,0.623,0.623,29,48,0.604,24,59,83,4,7,4,16,34,115
230,Kevin Huerter\huertke01,SG,20,ATL,53,37,1450,186,439,0.424,95,242,0.393,91,197,0.462,0.532,33,45,0.733,41,130,171,148,47,19,84,106,500
231,Chandler Hutchison\hutchch01,SF,22,CHI,44,14,895,96,209,0.459,14,50,0.28,82,159,0.516,0.493,23,38,0.605,31,154,185,34,23,6,25,59,229
232,Serge Ibaka\ibakase01,C,29,TOR,54,45,1553,361,683,0.529,34,134,0.254,327,549,0.596,0.553,112,143,0.783,113,313,426,79,27,70,93,165,868
233,Andre Iguodala\iguodan01,SF,35,GSW,50,11,1176,113,226,0.5,40,108,0.37,73,118,0.619,0.588,33,53,0.623,35,159,194,164,44,39,37,65,299
234,Ersan Ilyasova\ilyaser01,PF,31,MIL,44,3,774,103,240,0.429,34,100,0.34,69,140,0.493,0.5,34,38,0.895,63,131,194,39,26,11,36,112,274
235,Joe Ingles\inglejo01,SF,31,UTA,57,57,1772,241,549,0.439,116,315,0.368,125,234,0.534,0.545,68,94,0.723,18,198,216,282,75,12,128,134,666
236,Brandon Ingram\ingrabr01,SF,21,LAL,46,46,1538,301,622,0.484,22,77,0.286,279,545,0.512,0.502,159,241,0.66,35,187,222,139,27,28,115,124,783
237,Kyrie Irving\irvinky01,PG,26,BOS,47,47,1526,420,843,0.498,119,291,0.409,301,552,0.545,0.569,149,172,0.866,55,173,228,325,77,21,127,109,1108
238,Jonathan Isaac\isaacjo01,PF,21,ORL,52,41,1352,168,401,0.419,45,160,0.281,123,241,0.51,0.475,85,99,0.859,63,214,277,54,43,70,55,104,466
239,Wesley Iwundu\iwundwe01,SF,24,ORL,44,12,747,73,181,0.403,17,48,0.354,56,133,0.421,0.45,56,70,0.8,23,84,107,37,20,15,29,87,219
240,Demetrius Jackson\jacksde01,PG,24,PHI,6,0,39,8,15,0.533,2,6,0.333,6,9,0.667,0.6,4,4,1,2,1,3,5,2,0,1,4,22
241,Frank Jackson\jacksfr01,PG,20,NOP,43,7,658,101,236,0.428,27,90,0.3,74,146,0.507,0.485,31,40,0.775,14,57,71,39,14,1,28,59,260
242,Jaren Jackson\jacksja02,PF,19,MEM,57,55,1487,293,579,0.506,49,138,0.355,244,441,0.553,0.548,151,197,0.766,73,197,270,64,52,81,97,218,786
243,Josh Jackson\jacksjo02,SG,21,PHO,58,21,1411,249,597,0.417,46,153,0.301,203,444,0.457,0.456,106,159,0.667,50,200,250,137,59,39,135,150,650
244,Justin Jackson\jacksju01,SF,23,TOT,55,3,1103,129,304,0.424,57,163,0.35,72,141,0.511,0.518,43,52,0.827,25,121,146,69,24,13,22,68,358
245,Reggie Jackson\jacksre01,PG,28,DET,55,55,1597,282,683,0.413,113,311,0.363,169,372,0.454,0.496,139,159,0.874,34,118,152,244,38,6,98,156,816
246,LeBron James\jamesle01,SF,34,LAL,39,39,1363,383,747,0.513,81,228,0.355,302,519,0.582,0.567,197,290,0.679,37,300,337,298,52,25,135,65,1044
247,Amile Jefferson\jeffeam01,PF,25,ORL,4,0,14,0,3,0,0,0,,0,3,0,0,4,4,1,2,4,6,0,1,0,0,3,4
248,John Jenkins\jenkijo01,SG,27,TOT,5,0,23,5,7,0.714,3,5,0.6,2,2,1,0.929,0,0,,0,1,1,2,0,0,0,0,13
249,Jonas Jerebko\jerebjo01,PF,31,GSW,52,6,948,127,269,0.472,53,147,0.361,74,122,0.607,0.571,51,62,0.823,60,181,241,77,16,9,35,105,358
250,Alize Johnson\johnsal02,PF,22,IND,11,0,32,2,10,0.2,1,2,0.5,1,8,0.125,0.25,1,4,0.25,1,7,8,0,0,1,0,3,6
251,Amir Johnson\johnsam01,C,31,PHI,37,2,354,55,103,0.534,9,24,0.375,46,79,0.582,0.578,23,30,0.767,26,69,95,45,11,8,33,72,142
252,James Johnson\johnsja01,PF,31,MIA,39,33,821,118,280,0.421,36,106,0.34,82,174,0.471,0.486,33,44,0.75,16,109,125,92,26,19,52,79,305
253,Stanley Johnson\johnsst04,SF,22,TOT,51,7,993,136,361,0.377,51,186,0.274,85,175,0.486,0.447,41,51,0.804,27,155,182,60,50,13,56,97,364
254,Tyler Johnson\johnsty01,PG-SG,26,TOT,46,11,1182,176,422,0.417,74,213,0.347,102,209,0.488,0.505,63,90,0.7,22,104,126,117,43,21,67,80,489
255,Wesley Johnson\johnswe01,SF,31,TOT,29,13,436,43,102,0.422,23,59,0.39,20,43,0.465,0.534,8,12,0.667,11,48,59,19,13,10,14,51,117
256,Nikola Jokic\jokicni01,C,23,DEN,55,55,1731,423,835,0.507,62,199,0.312,361,636,0.568,0.544,214,253,0.846,153,424,577,422,78,36,175,157,1122
257,Damian Jones\jonesda03,C,23,GSW,24,22,410,53,74,0.716,0,0,,53,74,0.716,0.716,24,37,0.649,31,44,75,28,12,25,16,63,130
258,Derrick Jones\jonesde02,SF,21,MIA,37,5,668,104,203,0.512,19,52,0.365,85,151,0.563,0.559,45,73,0.616,67,95,162,18,30,26,25,72,272
259,Jalen Jones\jonesja04,SF,25,CLE,16,0,214,26,62,0.419,10,28,0.357,16,34,0.471,0.5,19,27,0.704,11,23,34,7,9,2,8,27,81
260,Tyus Jones\jonesty01,PG,22,MIN,43,6,873,90,237,0.38,22,74,0.297,68,163,0.417,0.426,32,38,0.842,13,59,72,170,54,3,27,39,234
261,DeAndre Jordan\jordade01,C,30,TOT,55,55,1687,229,353,0.649,0,0,,229,353,0.649,0.649,149,219,0.68,180,565,745,108,35,58,122,137,607
262,Cory Joseph\josepco01,PG,27,IND,57,3,1473,173,392,0.441,45,132,0.341,128,260,0.492,0.499,21,32,0.656,25,185,210,229,63,11,63,89,412
263,Frank Kaminsky\kaminfr01,C,25,CHO,25,0,276,47,99,0.475,15,44,0.341,32,55,0.582,0.551,22,35,0.629,19,43,62,26,5,5,18,25,131
264,Enes Kanter\kanteen01,C,26,NYK,44,23,1128,251,468,0.536,7,22,0.318,244,446,0.547,0.544,105,129,0.814,171,290,461,84,18,17,79,106,614
265,Luke Kennard\kennalu01,SG,22,DET,37,9,757,116,278,0.417,51,139,0.367,65,139,0.468,0.509,26,33,0.788,8,97,105,52,13,7,31,49,309
266,Michael Kidd-Gilchrist\kiddgmi01,PF,25,CHO,49,1,970,137,285,0.481,10,37,0.27,127,248,0.512,0.498,88,113,0.779,80,129,209,47,27,37,38,130,372
267,George King\kingge03,SF,25,PHO,1,0,6,0,0,,0,0,,0,0,,,0,0,,0,1,1,0,0,0,0,0,0
268,Maxi Kleber\klebima01,PF,27,DAL,51,14,1002,120,267,0.449,51,153,0.333,69,114,0.605,0.545,40,51,0.784,61,145,206,39,27,61,36,96,331
269,Brandon Knight\knighbr03,PG,27,TOT,14,1,146,17,55,0.309,11,39,0.282,6,16,0.375,0.409,9,11,0.818,1,11,12,13,2,0,7,15,54
270,Kevin Knox\knoxke01,PF,19,NYK,49,31,1396,219,599,0.366,82,244,0.336,137,355,0.386,0.434,97,134,0.724,40,167,207,47,28,16,73,116,617
271,Furkan Korkmaz\korkmfu01,SG,21,PHI,46,6,654,94,234,0.402,46,139,0.331,48,95,0.505,0.5,35,42,0.833,16,89,105,51,28,2,25,59,269
272,Luke Kornet\kornelu01,PF,23,NYK,27,10,402,64,149,0.43,43,100,0.43,21,49,0.429,0.574,19,23,0.826,15,51,66,33,15,16,14,20,190
273,Kyle Korver\korveky01,SG-PF,37,TOT,51,0,954,148,334,0.443,97,235,0.413,51,99,0.515,0.588,47,57,0.825,6,105,111,51,15,9,44,74,440
274,Kosta Koufos\koufoko01,C,29,SAC,30,1,372,53,109,0.486,0,0,,53,109,0.486,0.486,6,17,0.353,40,96,136,26,12,13,20,53,112
275,Rodions Kurucs\kurucro01,SF,20,BRK,41,29,856,138,301,0.458,33,110,0.3,105,191,0.55,0.513,50,57,0.877,39,109,148,30,24,12,47,94,359
276,Kyle Kuzma\kuzmaky01,PF,23,LAL,53,51,1732,385,825,0.467,104,326,0.319,281,499,0.563,0.53,140,183,0.765,45,252,297,124,34,19,106,120,1014
277,Skal Labissiere\labissk01,PF,22,SAC,13,0,113,13,30,0.433,4,11,0.364,9,19,0.474,0.5,6,11,0.545,4,20,24,6,2,3,7,21,36
278,Jeremy Lamb\lambje01,SG,26,CHO,53,53,1526,294,668,0.44,72,216,0.333,222,452,0.491,0.494,145,167,0.868,46,250,296,107,53,16,51,102,805
279,Zach LaVine\lavinza01,SG,23,CHI,50,49,1699,412,893,0.461,87,249,0.349,325,644,0.505,0.51,246,287,0.857,27,196,223,216,48,20,164,111,1157
280,Jake Layman\laymaja01,SF,24,POR,45,25,814,143,268,0.534,43,118,0.364,100,150,0.667,0.614,27,37,0.73,36,95,131,32,20,18,27,58,356
281,T.J. Leaf\leaftj01,PF,21,IND,36,0,296,55,100,0.55,5,23,0.217,50,77,0.649,0.575,9,16,0.563,18,48,66,15,4,9,10,24,124
282,Courtney Lee\leeco01,SG,33,TOT,15,2,179,21,48,0.438,5,17,0.294,16,31,0.516,0.49,9,14,0.643,6,22,28,17,9,2,6,15,56
283,Damion Lee\leeda03,SG,26,GSW,17,0,202,30,63,0.476,14,33,0.424,16,30,0.533,0.587,11,13,0.846,4,28,32,3,8,0,8,19,85
284,Alex Len\lenal01,C,25,ATL,53,20,1007,203,416,0.488,30,95,0.316,173,321,0.539,0.524,103,151,0.682,115,183,298,54,18,49,78,136,539
285,Kawhi Leonard\leonaka01,SF,27,TOR,43,43,1495,398,809,0.492,77,212,0.363,321,597,0.538,0.54,286,331,0.864,58,271,329,142,80,19,90,65,1159
286,Meyers Leonard\leoname01,C,26,POR,52,1,753,115,212,0.542,47,100,0.47,68,112,0.607,0.653,36,44,0.818,41,161,202,63,13,9,37,89,313
287,Jon Leuer\leuerjo01,PF,29,DET,32,1,346,60,99,0.606,0,9,0,60,90,0.667,0.606,22,29,0.759,22,65,87,12,12,4,22,52,142
288,Caris LeVert\leverca01,SF,24,BRK,16,14,454,105,226,0.465,19,69,0.275,86,157,0.548,0.507,45,63,0.714,14,48,62,60,23,6,35,38,274
289,Damian Lillard\lillada01,PG,28,POR,55,55,1945,477,1065,0.448,156,426,0.366,321,639,0.502,0.521,335,369,0.908,42,206,248,349,65,26,157,101,1445
290,Jeremy Lin\linje01,PG,30,ATL,51,1,1003,180,386,0.466,44,132,0.333,136,254,0.535,0.523,142,168,0.845,16,103,119,181,38,7,98,96,546
291,Shaun Livingston\livinsh01,PG,33,GSW,45,0,690,81,165,0.491,0,2,0,81,163,0.497,0.491,35,43,0.814,31,58,89,85,24,23,26,55,197
292,Zach Lofton\loftoza01,SG,26,DET,1,0,4,0,1,0,0,1,0,0,0,,0,0,0,,0,0,0,0,1,0,1,0,0
293,Kevon Looney\looneke01,C,22,GSW,56,22,1160,160,259,0.618,1,10,0.1,159,249,0.639,0.62,54,86,0.628,144,182,326,99,34,45,37,156,375
294,Brook Lopez\lopezbr01,C,30,MIL,56,56,1553,245,535,0.458,135,361,0.374,110,174,0.632,0.584,58,71,0.817,20,215,235,61,29,117,55,126,683
295,Robin Lopez\lopezro01,C,30,CHI,49,11,857,146,267,0.547,5,19,0.263,141,248,0.569,0.556,37,55,0.673,68,79,147,45,9,46,62,88,334
296,Kevin Love\loveke01,PF,30,CLE,6,6,158,26,80,0.325,9,33,0.273,17,47,0.362,0.381,33,39,0.846,10,54,64,16,1,1,13,15,94
297,Kyle Lowry\lowryky01,PG,32,TOR,46,46,1581,217,527,0.412,106,316,0.335,111,211,0.526,0.512,120,144,0.833,30,176,206,419,62,25,126,120,660
298,Jordan Loyd\loydjo01,PG,25,TOR,7,0,35,5,11,0.455,2,5,0.4,3,6,0.5,0.545,4,5,0.8,1,6,7,2,0,0,2,4,16
299,Kalin Lucas\lucaska01,PG,29,DET,1,0,6,0,1,0,0,1,0,0,0,,0,2,2,1,0,3,3,1,0,0,0,1,2
300,Timothe Luwawu-Cabarrot\luwawti01,SF-SG,23,TOT,25,1,189,23,71,0.324,11,38,0.289,12,33,0.364,0.401,9,12,0.75,5,27,32,5,6,2,7,24,66
301,Tyler Lydon\lydonty01,PF,22,DEN,21,0,87,8,17,0.471,4,10,0.4,4,7,0.571,0.588,1,3,0.333,6,10,16,5,2,0,4,10,21
302,Trey Lyles\lylestr01,PF,23,DEN,54,1,1017,192,453,0.424,46,181,0.254,146,272,0.537,0.475,74,106,0.698,41,181,222,77,28,23,61,84,504
303,Shelvin Mack\macksh01,PG,28,TOT,54,3,1216,161,391,0.412,46,128,0.359,115,263,0.437,0.471,53,77,0.688,18,84,102,183,46,4,62,82,421
304,Daryl Macon\maconda01,SG,23,DAL,4,0,8,2,2,1,0,0,,2,2,1,1,0,0,,0,0,0,0,1,0,1,0,4
305,J.P. Macura\macurjp01,SG,23,CHO,1,0,14,2,8,0.25,0,4,0,2,4,0.5,0.25,0,0,,0,2,2,2,0,0,0,0,4
306,Ian Mahinmi\mahinia01,C,32,WAS,31,6,445,41,83,0.494,1,12,0.083,40,71,0.563,0.5,41,60,0.683,39,68,107,24,24,15,20,75,124
307,Thon Maker\makerth01,C-PF,21,TOT,37,0,431,61,138,0.442,27,79,0.342,34,59,0.576,0.54,20,37,0.541,18,83,101,18,10,19,12,59,169
308,Boban Marjanovic\marjabo01,C,30,TOT,39,9,415,93,151,0.616,0,3,0,93,148,0.628,0.616,74,97,0.763,57,104,161,24,11,19,40,61,260
309,Lauri Markkanen\markkla01,PF,21,CHI,34,33,1096,224,512,0.438,85,224,0.379,139,288,0.483,0.521,93,107,0.869,44,253,297,39,26,25,54,79,626
310,Jarell Martin\martija01,PF,24,ORL,31,1,249,33,78,0.423,13,36,0.361,20,42,0.476,0.506,7,8,0.875,7,44,51,13,2,7,11,35,86
311,Frank Mason\masonfr01,PG,24,SAC,34,0,395,59,142,0.415,11,50,0.22,48,92,0.522,0.454,36,53,0.679,4,34,38,82,16,4,30,29,165
312,Wesley Matthews\matthwe02,SF-SG,32,TOT,47,46,1396,200,498,0.402,104,280,0.371,96,218,0.44,0.506,93,117,0.795,22,88,110,108,34,13,61,108,597
313,Luc Mbah a Moute\mbahalu01,PF,32,LAC,4,0,61,8,18,0.444,2,6,0.333,6,12,0.5,0.5,2,5,0.4,2,5,7,2,1,1,2,8,20
314,Patrick McCaw\mccawpa01,SG,23,TOT,13,0,165,9,28,0.321,2,13,0.154,7,15,0.467,0.357,6,6,1,6,19,25,11,10,1,10,16,26
315,CJ McCollum\mccolcj01,SG,27,POR,55,55,1877,455,993,0.458,124,343,0.362,331,650,0.509,0.521,127,153,0.83,47,174,221,152,46,20,86,132,1161
316,T.J. McConnell\mccontj01,PG,26,PHI,51,1,1061,154,276,0.558,12,34,0.353,142,242,0.587,0.58,20,26,0.769,19,95,114,195,62,14,67,83,340
317,Doug McDermott\mcderdo01,SF,27,IND,52,0,902,123,264,0.466,57,148,0.385,66,116,0.569,0.574,47,54,0.87,10,58,68,43,11,6,28,70,350
318,JaVale McGee\mcgeeja01,C,31,LAL,50,40,1083,245,406,0.603,1,8,0.125,244,398,0.613,0.605,66,104,0.635,119,224,343,36,31,99,72,127,557
319,Rodney McGruder\mcgruro01,SG,27,MIA,50,44,1265,158,391,0.404,65,187,0.348,93,204,0.456,0.487,39,51,0.765,43,142,185,98,27,8,59,101,420
320,Alfonzo McKinnie\mckinal01,SF,26,GSW,47,1,660,95,194,0.49,28,80,0.35,67,114,0.588,0.562,16,31,0.516,60,107,167,19,10,10,22,89,234
321,Ben McLemore\mclembe01,SG,25,SAC,19,0,158,25,64,0.391,17,41,0.415,8,23,0.348,0.523,8,12,0.667,3,14,17,4,6,3,5,22,75
322,Jordan McRae\mcraejo01,SG,27,WAS,18,0,163,33,64,0.516,8,14,0.571,25,50,0.5,0.578,7,12,0.583,4,17,21,11,6,5,8,9,81
323,Salah Mejri\mejrisa01,C,32,DAL,16,1,108,15,28,0.536,0,2,0,15,26,0.577,0.536,7,8,0.875,12,26,38,6,2,3,4,16,37
324,De'Anthony Melton\meltode01,PG,20,PHO,33,25,675,71,193,0.368,24,77,0.312,47,116,0.405,0.43,15,18,0.833,16,70,86,110,50,17,55,85,181
325,Chimezie Metu\metuch01,PF,21,SAS,26,0,135,17,54,0.315,0,2,0,17,52,0.327,0.315,13,17,0.765,9,25,34,13,6,2,13,12,47
326,Khris Middleton\middlkh01,SF,27,MIL,53,53,1646,324,739,0.438,120,318,0.377,204,421,0.485,0.52,140,164,0.854,27,282,309,222,58,5,119,119,908
327,C.J. Miles\milescj01,SF,31,TOT,42,1,606,79,223,0.354,46,145,0.317,33,78,0.423,0.457,37,46,0.804,12,62,74,26,18,10,22,65,241
328,Darius Miller\milleda01,SF,28,NOP,53,14,1339,141,363,0.388,104,279,0.373,37,84,0.44,0.532,36,43,0.837,8,85,93,94,33,21,41,128,422
329,Patty Mills\millspa02,PG,30,SAS,59,1,1404,206,470,0.438,113,277,0.408,93,193,0.482,0.559,70,82,0.854,19,118,137,182,41,9,68,90,595
330,Paul Millsap\millspa01,PF,33,DEN,45,40,1150,197,407,0.484,31,89,0.348,166,318,0.522,0.522,112,155,0.723,91,203,294,85,55,38,60,111,537
331,Shake Milton\miltosh01,SG,22,PHI,13,0,126,20,46,0.435,10,25,0.4,10,21,0.476,0.543,4,5,0.8,7,13,20,13,4,3,3,14,54
332,Nikola Mirotic\mirotni01,PF,27,NOP,32,22,925,182,407,0.447,85,231,0.368,97,176,0.551,0.552,85,101,0.842,46,218,264,35,21,25,37,86,534
333,Donovan Mitchell\mitchdo01,SG,22,UTA,53,53,1765,435,1040,0.418,115,357,0.322,320,683,0.469,0.474,204,257,0.794,37,170,207,211,81,18,145,143,1189
334,Naz Mitrou-Long\mitrona01,SG,25,UTA,10,0,39,2,8,0.25,1,6,0.167,1,2,0.5,0.313,0,0,,0,2,2,4,0,0,3,5,5
335,Malik Monk\monkma01,SG,20,CHO,53,0,973,187,473,0.395,87,257,0.339,100,216,0.463,0.487,79,88,0.898,10,82,92,95,28,14,70,75,540
336,Greg Monroe\monrogr01,C,28,TOR,38,2,423,74,161,0.46,0,4,0,74,157,0.471,0.46,35,61,0.574,60,96,156,16,13,8,31,61,183
337,E'Twaun Moore\mooreet01,SF,29,NOP,46,36,1336,231,479,0.482,64,152,0.421,167,327,0.511,0.549,38,50,0.76,34,81,115,91,34,8,54,101,564
338,Eric Moreland\moreler01,PF,27,PHO,1,0,5,0,0,,0,0,,0,0,,,0,0,,0,3,3,0,0,0,0,1,0
339,Jaylen Morris\morrija01,SG,23,MIL,4,0,29,4,10,0.4,1,3,0.333,3,7,0.429,0.45,1,2,0.5,0,5,5,4,2,0,1,1,10
340,Marcus Morris\morrima03,PF,29,BOS,52,35,1437,276,578,0.478,109,265,0.411,167,313,0.534,0.572,99,113,0.876,46,270,316,74,32,17,65,128,760
341,Markieff Morris\morrima02,PF,29,WAS,34,15,883,143,328,0.436,48,144,0.333,95,184,0.516,0.509,57,73,0.781,41,133,174,60,25,20,47,117,391
342,Monte Morris\morrimo01,PG,23,DEN,56,5,1400,248,497,0.499,69,157,0.439,179,340,0.526,0.568,41,53,0.774,24,124,148,221,51,2,35,69,606
343,Johnathan Motley\motlejo01,PF,23,LAC,14,0,118,27,57,0.474,0,3,0,27,54,0.5,0.474,18,29,0.621,14,21,35,5,3,2,12,18,72
344,Emmanuel Mudiay\mudiaem01,PG,22,NYK,39,32,1036,219,483,0.453,41,133,0.308,178,350,0.509,0.496,95,125,0.76,25,95,120,152,31,13,83,70,574
345,Jamal Murray\murraja01,PG,21,DEN,50,49,1676,348,808,0.431,98,267,0.367,250,541,0.462,0.491,127,151,0.841,47,167,214,250,41,19,119,104,921
346,Dzanan Musa\musadz01,SG,19,BRK,8,0,34,8,20,0.4,0,9,0,8,11,0.727,0.4,0,2,0,1,3,4,1,2,0,4,1,16
347,Mike Muscala\muscami01,PF,27,TOT,48,6,1054,112,285,0.393,70,204,0.343,42,81,0.519,0.516,63,77,0.818,51,150,201,64,18,27,43,113,357
348,Sviatoslav Mykhailiuk\mykhasv01,SF-SG,21,TOT,40,0,429,45,136,0.331,28,87,0.322,17,49,0.347,0.434,12,20,0.6,8,27,35,35,13,1,21,25,130
349,Abdel Nader\naderab01,SF,25,OKC,37,1,371,57,123,0.463,17,47,0.362,40,76,0.526,0.533,14,18,0.778,7,58,65,10,9,2,15,42,145
350,Larry Nance\nancela02,C,26,CLE,47,20,1224,168,323,0.52,19,53,0.358,149,270,0.552,0.55,72,100,0.72,118,265,383,144,66,32,63,133,427
351,Shabazz Napier\napiesh01,PG,27,BRK,46,2,827,141,359,0.393,63,179,0.352,78,180,0.433,0.481,106,129,0.822,14,70,84,116,38,14,56,55,451
352,Raul Neto\netora01,PG,26,UTA,22,1,263,42,81,0.519,10,31,0.323,32,50,0.64,0.58,17,20,0.85,2,29,31,48,8,0,20,25,111
353,Georges Niang\niangge01,PF,25,UTA,42,0,312,46,104,0.442,29,71,0.408,17,33,0.515,0.582,10,13,0.769,7,47,54,21,7,3,13,37,131
354,Joakim Noah\noahjo01,C,33,MEM,28,0,396,58,116,0.5,0,0,,58,116,0.5,0.5,29,44,0.659,37,95,132,42,13,15,29,52,145
355,Nerlens Noel\noelne01,C,24,OKC,52,2,742,107,187,0.572,0,0,,107,187,0.572,0.572,35,48,0.729,86,152,238,30,51,71,31,116,249
356,Dirk Nowitzki\nowitdi01,PF,40,DAL,25,0,269,39,110,0.355,23,71,0.324,16,39,0.41,0.459,10,12,0.833,0,43,43,8,3,8,8,32,111
357,Frank Ntilikina\ntilila01,PG,20,NYK,41,16,872,94,275,0.342,32,110,0.291,62,165,0.376,0.4,21,28,0.75,10,72,82,116,30,14,54,100,241
358,James Nunnally\nunnaja01,SF,28,TOT,15,0,102,12,34,0.353,8,25,0.32,4,9,0.444,0.471,4,4,1,0,5,5,7,1,0,1,10,36
359,Jusuf Nurkic\nurkiju01,C,24,POR,55,55,1504,311,617,0.504,3,25,0.12,308,592,0.52,0.506,205,271,0.756,186,374,560,177,58,85,125,190,830
360,David Nwaba\nwabada01,SG,26,CLE,26,10,469,61,138,0.442,12,43,0.279,49,95,0.516,0.486,38,60,0.633,22,59,81,22,17,7,15,44,172
361,Royce O'Neale\onealro01,SF,25,UTA,57,9,1068,112,227,0.493,47,107,0.439,65,120,0.542,0.597,27,36,0.75,18,172,190,76,38,16,49,107,298
362,Kyle O'Quinn\oquinky01,C,28,IND,32,0,223,36,81,0.444,1,11,0.091,35,70,0.5,0.451,9,10,0.9,17,54,71,32,3,18,21,42,82
363,Semi Ojeleye\ojelese01,PF,24,BOS,39,2,410,47,112,0.42,19,65,0.292,28,47,0.596,0.504,14,20,0.7,16,44,60,14,8,3,13,29,127
364,Jahlil Okafor\okafoja01,C,23,NOP,37,13,548,126,212,0.594,0,1,0,126,211,0.597,0.594,38,53,0.717,58,115,173,19,11,25,28,67,290
365,Elie Okobo\okoboel01,PG,21,PHO,40,11,760,89,235,0.379,28,103,0.272,61,132,0.462,0.438,28,33,0.848,8,73,81,106,25,5,55,92,234
366,Josh Okogie\okogijo01,SG,20,MIN,48,26,1080,119,331,0.36,37,144,0.257,82,187,0.439,0.415,79,104,0.76,27,118,145,53,46,17,48,111,354
367,Victor Oladipo\oladivi01,SG,26,IND,36,36,1147,249,588,0.423,74,216,0.343,175,372,0.47,0.486,103,141,0.73,21,181,202,186,60,11,82,72,675
368,Kelly Olynyk\olynyke01,PF,27,MIA,52,9,1056,152,339,0.448,71,212,0.335,81,127,0.638,0.553,93,118,0.788,49,179,228,89,31,20,76,115,468
369,Cedi Osman\osmande01,SF,23,CLE,51,50,1608,234,552,0.424,78,241,0.324,156,311,0.502,0.495,97,128,0.758,29,207,236,115,39,9,85,133,643
370,Kelly Oubre\oubreke01,SF,23,TOT,56,7,1508,275,634,0.434,82,264,0.311,193,370,0.522,0.498,145,186,0.78,53,199,252,63,59,48,74,146,777
371,Zaza Pachulia\pachuza01,C,34,DET,45,3,659,65,144,0.451,0,4,0,65,140,0.464,0.451,75,98,0.765,85,124,209,65,29,15,39,108,205
372,Jabari Parker\parkeja01,PF,23,TOT,42,17,1120,232,488,0.475,38,123,0.309,194,365,0.532,0.514,81,112,0.723,42,220,262,101,27,17,90,94,583
373,Tony Parker\parketo01,PG,36,CHO,46,0,837,175,383,0.457,9,40,0.225,166,343,0.484,0.469,81,111,0.73,11,56,67,177,17,5,60,47,440
374,Chandler Parsons\parsoch01,SF,30,MEM,3,3,46,7,17,0.412,3,10,0.3,4,7,0.571,0.5,0,0,,1,3,4,2,1,1,2,7,17
375,Patrick Patterson\pattepa01,PF,29,OKC,56,4,824,80,209,0.383,46,132,0.348,34,77,0.442,0.493,18,29,0.621,40,99,139,31,16,13,20,41,224
376,Chris Paul\paulch01,PG,33,HOU,33,33,1070,172,407,0.423,69,194,0.356,103,213,0.484,0.507,102,123,0.829,19,117,136,264,70,9,94,83,515
377,Cameron Payne\payneca01,PG,24,TOT,40,13,712,96,223,0.43,25,84,0.298,71,139,0.511,0.487,33,41,0.805,13,59,72,106,28,9,45,64,250
378,Elfrid Payton\paytoel01,PG,24,NOP,19,19,512,75,171,0.439,13,37,0.351,62,134,0.463,0.477,23,31,0.742,14,56,70,111,22,5,45,37,186
379,Gary Payton\paytoga02,PG,26,WAS,3,0,16,5,8,0.625,1,2,0.5,4,6,0.667,0.688,0,0,,1,1,2,4,3,1,1,2,11
380,Theo Pinson\pinsoth01,SG,23,BRK,11,0,161,18,52,0.346,8,30,0.267,10,22,0.455,0.423,15,16,0.938,2,27,29,17,4,0,14,11,59
381,Mason Plumlee\plumlma01,C,28,DEN,56,16,1154,188,306,0.614,1,6,0.167,187,300,0.623,0.616,79,146,0.541,114,221,335,149,50,52,89,178,456
382,Miles Plumlee\plumlmi01,C,30,ATL,18,0,173,32,48,0.667,0,0,,32,48,0.667,0.667,16,30,0.533,16,23,39,17,6,4,10,14,80
383,Jakob Poeltl\poeltja01,C,23,SAS,55,8,814,123,192,0.641,0,0,,123,192,0.641,0.641,38,68,0.559,114,145,259,68,13,35,39,85,284
384,Quincy Pondexter\pondequ01,SF,30,SAS,43,0,247,24,49,0.49,6,18,0.333,18,31,0.581,0.551,27,35,0.771,7,33,40,22,9,1,10,21,81
385,Otto Porter\porteot01,SF,25,TOT,44,31,1296,222,480,0.463,73,190,0.384,149,290,0.514,0.539,54,71,0.761,45,199,244,87,67,23,46,86,571
386,Bobby Portis\portibo01,PF,23,TOT,25,6,619,147,317,0.464,37,90,0.411,110,227,0.485,0.522,43,56,0.768,50,134,184,36,14,9,35,69,374
387,Dwight Powell\poweldw01,C,27,DAL,52,0,901,162,279,0.581,18,73,0.247,144,206,0.699,0.613,112,149,0.752,72,156,228,52,26,31,42,127,454
388,Norman Powell\powelno01,SG,25,TOR,36,2,664,112,233,0.481,37,101,0.366,75,132,0.568,0.56,38,47,0.809,7,61,68,56,24,8,32,61,299
389,Alex Poythress\poythal01,PF,25,ATL,18,1,243,35,65,0.538,7,18,0.389,28,47,0.596,0.592,11,21,0.524,24,35,59,13,3,8,10,39,88
390,Zhou Qi\qizh01,PF,23,HOU,1,0,1,1,1,1,0,0,,1,1,1,1,0,0,,0,0,0,0,0,0,0,0,2
391,Ivan Rabb\rabbiv01,PF,21,MEM,28,4,311,58,95,0.611,1,4,0.25,57,91,0.626,0.616,23,36,0.639,36,65,101,21,5,7,19,38,140
392,Chasson Randle\randlch01,PG,25,WAS,27,1,423,56,123,0.455,27,59,0.458,29,64,0.453,0.565,24,36,0.667,7,27,34,58,12,1,30,56,163
393,Julius Randle\randlju01,C,24,NOP,51,27,1497,370,684,0.541,35,105,0.333,335,579,0.579,0.567,240,325,0.738,107,357,464,149,32,32,133,174,1015
394,J.J. Redick\redicjj01,SG,34,PHI,53,40,1649,331,730,0.453,166,419,0.396,165,311,0.531,0.567,159,176,0.903,16,101,117,148,22,10,76,92,987
395,Davon Reed\reedda01,SG,23,IND,7,0,20,2,4,0.5,1,1,1,1,3,0.333,0.625,0,0,,1,1,2,2,0,0,1,1,5
396,Josh Richardson\richajo01,SG,25,MIA,53,53,1836,323,776,0.416,132,345,0.383,191,431,0.443,0.501,157,181,0.867,38,151,189,205,59,26,94,149,935
397,Malachi Richardson\richama01,SG,23,TOR,22,0,103,9,29,0.31,8,25,0.32,1,4,0.25,0.448,4,5,0.8,2,11,13,0,1,0,8,13,30
398,Austin Rivers\riverau01,SG-PG,26,TOT,53,15,1481,172,426,0.404,79,246,0.321,93,180,0.517,0.496,40,74,0.541,21,108,129,134,32,17,55,152,463
399,Devin Robinson\robinde01,SF,23,WAS,4,0,32,8,13,0.615,0,0,,8,13,0.615,0.615,3,6,0.5,2,5,7,2,3,1,0,2,19
400,Duncan Robinson\robindu01,PF,24,MIA,6,0,36,3,8,0.375,2,7,0.286,1,1,1,0.5,0,0,,0,7,7,0,1,0,0,1,8
401,Glenn Robinson\robingl02,SF,25,DET,32,17,438,46,120,0.383,13,43,0.302,33,77,0.429,0.438,27,33,0.818,10,31,41,13,11,5,17,30,132
402,Jerome Robinson\robinje01,SG,21,LAC,22,0,214,28,72,0.389,14,40,0.35,14,32,0.438,0.486,4,6,0.667,3,20,23,7,7,2,3,35,74
403,Mitchell Robinson\robinmi01,C,20,NYK,40,12,703,104,148,0.703,0,0,,104,148,0.703,0.703,30,59,0.508,91,86,177,22,27,81,19,121,238
404,Rajon Rondo\rondora01,PG,32,LAL,23,9,644,86,194,0.443,22,52,0.423,64,142,0.451,0.5,11,20,0.55,19,98,117,174,20,4,59,58,205
405,Derrick Rose\rosede01,PG,30,MIN,40,13,1146,287,599,0.479,53,131,0.405,234,468,0.5,0.523,109,128,0.852,25,85,110,191,26,11,66,44,736
406,Terrence Ross\rosste01,SG,27,ORL,58,0,1528,313,724,0.432,141,370,0.381,172,354,0.486,0.53,76,88,0.864,20,174,194,89,52,22,58,89,843
407,Terry Rozier\roziete01,PG,24,BOS,57,10,1326,185,481,0.385,88,242,0.364,97,239,0.406,0.476,58,71,0.817,26,212,238,182,54,16,52,72,516
408,Ricky Rubio\rubiori01,PG,28,UTA,50,49,1437,229,561,0.408,67,208,0.322,162,353,0.459,0.468,125,148,0.845,22,161,183,304,65,9,145,135,650
409,D'Angelo Russell\russeda01,PG,22,BRK,57,57,1703,441,1011,0.436,154,412,0.374,287,599,0.479,0.512,103,125,0.824,32,180,212,377,65,16,165,94,1139
410,Domantas Sabonis\sabondo01,C,22,IND,55,5,1360,305,503,0.606,8,13,0.615,297,490,0.606,0.614,155,208,0.745,137,370,507,150,36,24,120,173,773
411,Brandon Sampson\sampsbr01,SG,21,CHI,4,0,28,5,7,0.714,2,4,0.5,3,3,1,0.857,0,0,,0,4,4,1,0,0,0,3,12
412,Dario Saric\saricda01,PF,24,TOT,55,15,1366,196,458,0.428,79,218,0.362,117,240,0.488,0.514,84,95,0.884,82,229,311,85,30,6,64,127,555
413,Tomas Satoransky\satorto01,SG,27,WAS,56,30,1374,164,336,0.488,43,99,0.434,121,237,0.511,0.552,75,95,0.789,50,129,179,242,54,10,70,115,446
414,Dennis Schroder\schrode01,PG,25,OKC,54,10,1527,320,752,0.426,82,228,0.36,238,524,0.454,0.48,128,156,0.821,22,159,181,220,50,8,125,123,850
415,Mike Scott\scottmi01,PF,30,TOT,55,0,799,96,242,0.397,53,138,0.384,43,104,0.413,0.506,12,19,0.632,25,152,177,47,19,8,27,94,257
416,Thabo Sefolosha\sefolth01,SF,34,UTA,27,0,292,29,59,0.492,13,29,0.448,16,30,0.533,0.602,8,14,0.571,4,69,73,10,23,2,15,23,79
417,Wayne Selden\seldewa01,SG,24,TOT,50,5,845,113,270,0.419,38,103,0.369,75,167,0.449,0.489,39,51,0.765,22,56,78,65,17,7,45,81,303
418,Collin Sexton\sextoco01,PG,20,CLE,57,47,1721,324,796,0.407,60,153,0.392,264,643,0.411,0.445,141,165,0.855,41,132,173,162,30,3,127,138,849
419,Landry Shamet\shamela01,SG-PG,21,TOT,56,4,1168,162,363,0.446,106,257,0.412,56,106,0.528,0.592,51,62,0.823,16,67,83,64,27,8,27,109,481
420,Iman Shumpert\shumpim01,SG,28,TOT,44,40,1148,136,361,0.377,77,214,0.36,59,147,0.401,0.483,34,41,0.829,21,114,135,95,50,21,40,99,383
421,Pascal Siakam\siakapa01,PF,24,TOR,57,56,1795,345,628,0.549,43,133,0.323,302,495,0.61,0.584,159,202,0.787,92,305,397,162,56,36,101,171,892
422,Ben Simmons\simmobe01,PG,22,PHI,56,56,1894,379,666,0.569,0,3,0,379,663,0.572,0.569,179,305,0.587,123,386,509,443,74,41,199,136,937
423,Jonathon Simmons\simmojo02,SG-SF,29,TOT,43,9,863,107,289,0.37,20,84,0.238,87,205,0.424,0.405,59,75,0.787,23,79,102,98,19,14,57,70,293
424,Kobi Simmons\simmoko01,PG,21,CLE,1,0,2,0,0,,0,0,,0,0,,,0,0,,0,0,0,0,0,0,0,0,0
425,Anfernee Simons\simonan01,SG,19,POR,11,0,59,7,24,0.292,0,8,0,7,16,0.438,0.292,1,4,0.25,0,7,7,4,0,0,7,3,15
426,Marcus Smart\smartma01,SG,24,BOS,56,36,1508,151,380,0.397,86,242,0.355,65,138,0.471,0.511,71,91,0.78,37,122,159,229,94,22,76,138,459
427,Dennis Smith\smithde03,PG,21,TOT,37,37,1070,189,435,0.434,48,148,0.324,141,287,0.491,0.49,75,115,0.652,24,89,113,168,49,14,112,97,501
428,Ish Smith\smithis01,PG,30,DET,29,0,649,97,247,0.393,32,91,0.352,65,156,0.417,0.457,18,24,0.75,4,53,57,84,13,8,32,62,244
429,J.R. Smith\smithjr01,SG,33,CLE,11,4,222,27,79,0.342,12,39,0.308,15,40,0.375,0.418,8,10,0.8,0,18,18,21,11,3,11,19,74
430,Jason Smith\smithja02,C-PF,32,TOT,18,1,170,19,50,0.38,7,19,0.368,12,31,0.387,0.45,12,14,0.857,14,34,48,13,3,7,12,27,57
431,Tony Snell\snellto01,SG,27,MIL,56,8,968,125,271,0.461,64,158,0.405,61,113,0.54,0.579,33,37,0.892,21,92,113,50,21,12,19,61,347
432,Ray Spalding\spaldra01,PF,21,DAL,1,0,1,0,0,,0,0,,0,0,,,0,0,,0,0,0,0,0,0,0,0,0
433,Omari Spellman\spellom01,PF,21,ATL,40,10,689,83,211,0.393,39,113,0.345,44,98,0.449,0.486,30,42,0.714,60,99,159,36,24,22,26,60,235
434,Nik Stauskas\stausni01,SG,25,TOT,45,0,693,97,238,0.408,44,132,0.333,53,106,0.5,0.5,32,36,0.889,11,74,85,63,14,5,42,33,270
435,D.J. Stephens\stephdj01,SG,28,MEM,1,0,7,1,2,0.5,0,0,,1,2,0.5,0.5,0,0,,0,0,0,0,1,0,1,0,2
436,Lance Stephenson\stephla01,SG,28,LAL,56,0,902,159,361,0.44,62,162,0.383,97,199,0.487,0.526,42,63,0.667,26,140,166,115,35,5,74,92,422
437,Edmond Sumner\sumneed01,PG,23,IND,17,2,167,16,49,0.327,4,20,0.2,12,29,0.414,0.367,5,12,0.417,7,12,19,7,9,5,8,21,41
438,Caleb Swanigan\swanica01,PF,21,POR,18,0,145,14,44,0.318,1,5,0.2,13,39,0.333,0.33,6,7,0.857,13,39,52,7,4,0,16,22,35
439,Jayson Tatum\tatumja01,SF,20,BOS,57,57,1774,344,759,0.453,89,235,0.379,255,524,0.487,0.512,160,186,0.86,56,305,361,106,58,48,83,125,937
440,Jeff Teague\teaguje01,PG,30,MIN,33,32,991,131,315,0.416,29,83,0.349,102,232,0.44,0.462,97,120,0.808,12,71,83,265,36,13,76,69,388
441,Garrett Temple\templga01,SG,32,TOT,51,51,1568,171,399,0.429,76,217,0.35,95,182,0.522,0.524,60,80,0.75,20,136,156,72,50,25,56,137,478
442,Milos Teodosic\teodomi01,PG,31,LAC,15,0,150,17,40,0.425,10,27,0.37,7,13,0.538,0.55,4,7,0.571,3,13,16,32,3,1,21,27,48
443,Jared Terrell\terreja01,SG,23,MIN,7,0,67,8,26,0.308,4,11,0.364,4,15,0.267,0.385,1,2,0.5,1,2,3,7,3,1,7,8,21
444,Emanuel Terry\terryem01,PF,22,PHO,2,0,20,4,6,0.667,0,0,,4,6,0.667,0.667,1,2,0.5,2,4,6,1,3,0,2,4,9
445,Daniel Theis\theisda01,C,26,BOS,43,2,652,113,193,0.585,23,48,0.479,90,145,0.621,0.645,44,60,0.733,64,107,171,49,15,27,24,113,293
446,Khyri Thomas\thomakh01,SG,22,DET,17,0,152,17,46,0.37,10,27,0.37,7,19,0.368,0.478,6,9,0.667,3,11,14,5,5,4,3,14,50
447,Lance Thomas\thomala01,PF,30,NYK,25,11,413,34,91,0.374,7,36,0.194,27,55,0.491,0.412,19,23,0.826,11,49,60,12,16,6,13,50,94
448,Klay Thompson\thompkl01,SG,28,GSW,55,55,1878,476,1003,0.475,164,412,0.398,312,591,0.528,0.556,99,123,0.805,23,196,219,115,63,38,85,118,1215
449,Tristan Thompson\thomptr01,C,27,CLE,35,35,1043,173,329,0.526,0,0,,173,329,0.526,0.526,55,85,0.647,154,235,389,75,28,16,50,81,401
450,Sindarius Thornwell\thornsi01,SG,24,LAC,40,1,232,15,40,0.375,2,13,0.154,13,27,0.481,0.4,16,23,0.696,3,31,34,14,11,3,16,32,48
451,Anthony Tolliver\tollian01,PF,33,MIN,39,0,578,50,125,0.4,41,109,0.376,9,16,0.563,0.564,21,28,0.75,11,73,84,20,12,11,20,53,162
452,Karl-Anthony Towns\townska01,C,23,MIN,56,56,1855,468,917,0.51,97,253,0.383,371,664,0.559,0.563,261,308,0.847,191,486,677,179,53,99,163,209,1294
453,Gary Trent\trentga02,SG,20,POR,8,0,34,5,18,0.278,3,8,0.375,2,10,0.2,0.361,1,4,0.25,0,4,4,1,0,1,1,1,14
454,Allonzo Trier\trieral01,SG,23,NYK,49,3,1079,164,372,0.441,31,85,0.365,133,287,0.463,0.483,123,148,0.831,24,123,147,95,21,14,88,80,482
455,P.J. Tucker\tuckepj01,PF,33,HOU,56,56,1980,148,378,0.392,96,266,0.361,52,112,0.464,0.519,33,51,0.647,89,262,351,72,90,26,49,174,425
456,Evan Turner\turneev01,PG,30,POR,55,2,1300,173,370,0.468,7,45,0.156,166,325,0.511,0.477,56,81,0.691,32,220,252,217,28,14,93,90,409
457,Myles Turner\turnemy01,C,22,IND,52,52,1467,282,549,0.514,49,119,0.412,233,430,0.542,0.558,91,127,0.717,70,294,364,85,39,143,71,134,704
458,Ekpe Udoh\udohek01,C,31,UTA,35,0,192,28,39,0.718,0,0,,28,39,0.718,0.718,10,16,0.625,12,28,40,14,4,17,8,23,66
459,Tyler Ulis\ulisty01,PG,23,CHI,1,0,1,0,0,,0,0,,0,0,,,0,0,,0,0,0,0,0,0,0,0,0
460,Jonas Valanciunas\valanjo01,C,26,TOT,31,10,585,158,270,0.585,9,31,0.29,149,239,0.623,0.602,82,102,0.804,56,170,226,31,13,23,40,85,407
461,Jarred Vanderbilt\vandeja01,PF,19,DEN,3,0,14,0,4,0,0,0,,0,4,0,0,1,2,0.5,2,9,11,1,2,1,1,0,1
462,Fred VanVleet\vanvlfr01,PG,24,TOR,51,22,1369,189,469,0.403,85,232,0.366,104,237,0.439,0.494,75,90,0.833,20,118,138,234,45,12,65,90,538
463,Noah Vonleh\vonleno01,PF,23,NYK,56,47,1449,166,366,0.454,43,124,0.347,123,242,0.508,0.512,94,130,0.723,97,362,459,110,41,47,73,144,469
464,Nikola Vucevic\vucevni01,C,28,ORL,57,57,1777,496,952,0.521,64,169,0.379,432,783,0.552,0.555,118,151,0.781,153,535,688,218,53,65,114,109,1174
465,Dwyane Wade\wadedw01,SG,37,MIA,45,0,1147,235,550,0.427,53,164,0.323,182,386,0.472,0.475,98,141,0.695,41,130,171,196,30,21,101,72,621
466,Moritz Wagner\wagnemo01,C,21,LAL,22,0,146,26,61,0.426,12,30,0.4,14,31,0.452,0.525,9,15,0.6,8,25,33,9,5,3,11,17,73
467,Dion Waiters\waitedi01,SG,27,MIA,17,3,375,62,156,0.397,33,96,0.344,29,60,0.483,0.503,1,9,0.111,2,35,37,45,9,2,20,14,158
468,Kemba Walker\walkeke02,PG,28,CHO,56,56,1934,487,1120,0.435,187,510,0.367,300,610,0.492,0.518,251,302,0.831,32,215,247,317,70,27,143,88,1412
469,Lonnie Walker\walkelo01,SG,20,SAS,6,0,57,4,21,0.19,2,6,0.333,2,15,0.133,0.238,4,4,1,0,10,10,2,3,1,4,3,14
470,John Wall\walljo01,PG,28,WAS,32,32,1104,245,552,0.444,51,169,0.302,194,383,0.507,0.49,122,175,0.697,15,101,116,279,49,29,121,71,663
471,Tyrone Wallace\wallaty01,PG,24,LAC,43,0,437,68,161,0.422,2,14,0.143,66,147,0.449,0.429,20,43,0.465,18,52,70,23,16,7,20,55,158
472,Taurean Waller-Prince\princta02,SF,24,ATL,36,28,993,172,386,0.446,80,206,0.388,92,180,0.511,0.549,60,72,0.833,15,117,132,70,36,14,70,94,484
473,Brad Wanamaker\wanambr01,PG,29,BOS,26,0,236,32,70,0.457,15,30,0.5,17,40,0.425,0.564,14,15,0.933,2,23,25,35,9,1,13,18,93
474,T.J. Warren\warretj01,SF,25,PHO,43,36,1360,297,611,0.486,77,180,0.428,220,431,0.51,0.549,101,124,0.815,31,143,174,64,51,29,52,119,772
475,Julian Washburn\washbju01,SF,27,MEM,6,2,110,3,19,0.158,1,8,0.125,2,11,0.182,0.184,3,4,0.75,4,16,20,3,4,0,3,5,10
476,Yuta Watanabe\watanyu01,SG,24,MEM,10,0,98,10,28,0.357,2,9,0.222,8,19,0.421,0.393,7,10,0.7,1,18,19,4,2,1,4,3,29
477,Thomas Welsh\welshth01,C,22,DEN,9,0,33,5,10,0.5,3,7,0.429,2,3,0.667,0.65,1,2,0.5,0,4,4,4,0,0,1,2,14
478,Russell Westbrook\westbru01,PG,30,OKC,48,48,1705,384,933,0.412,53,217,0.244,331,716,0.462,0.44,198,304,0.651,68,467,535,537,107,19,221,164,1019
479,Derrick White\whitede01,PG,24,SAS,45,33,1138,167,334,0.5,31,87,0.356,136,247,0.551,0.546,67,87,0.77,22,132,154,163,45,23,67,95,432
480,Okaro White\whiteok01,PF,26,WAS,3,0,6,0,2,0,0,2,0,0,0,,0,0,0,,1,1,2,0,0,0,0,0,0
481,Hassan Whiteside\whiteha01,C,29,MIA,49,49,1246,274,498,0.55,2,15,0.133,272,483,0.563,0.552,84,193,0.435,187,424,611,43,34,105,79,136,634
482,Andrew Wiggins\wiggian01,SF,23,MIN,51,51,1772,337,850,0.396,79,239,0.331,258,611,0.422,0.443,160,224,0.714,63,182,245,122,55,31,96,103,913
483,Alan Williams\willial03,PF,26,BRK,3,0,17,4,8,0.5,0,1,0,4,7,0.571,0.5,2,4,0.5,3,11,14,2,0,0,1,2,10
484,C.J. Williams\willicj01,SG,28,MIN,9,0,67,7,17,0.412,1,7,0.143,6,10,0.6,0.441,0,0,,1,3,4,6,1,0,4,11,15
485,Johnathan Williams\willijo04,C,23,LAL,7,0,89,11,20,0.55,0,0,,11,20,0.55,0.55,1,5,0.2,11,10,21,4,1,4,2,20,23
486,Kenrich Williams\willike04,SF,24,NOP,22,5,364,43,100,0.43,17,48,0.354,26,52,0.5,0.515,8,13,0.615,19,69,88,26,4,8,12,35,111
487,Lou Williams\willilo02,SG,32,LAC,52,0,1360,327,774,0.422,72,196,0.367,255,578,0.441,0.469,297,332,0.895,21,131,152,272,33,8,127,54,1023
488,Marvin Williams\willima02,PF,32,CHO,55,55,1561,207,488,0.424,111,296,0.375,96,192,0.5,0.538,48,66,0.727,50,256,306,68,51,41,28,119,573
489,Robert Williams\williro04,C,21,BOS,23,0,200,28,38,0.737,0,0,,28,38,0.737,0.737,6,10,0.6,19,36,55,5,6,32,8,28,62
490,Troy Williams\willitr02,SF,24,SAC,18,0,286,40,87,0.46,14,41,0.341,26,46,0.565,0.54,9,15,0.6,9,46,55,10,10,8,8,34,103
491,D.J. Wilson\wilsodj01,PF,22,MIL,28,0,520,62,141,0.44,27,71,0.38,35,70,0.5,0.535,11,28,0.393,25,103,128,28,12,18,17,55,162
492,Justise Winslow\winslju01,PF,22,MIA,50,37,1483,237,562,0.422,72,194,0.371,165,368,0.448,0.486,73,113,0.646,51,216,267,205,48,15,109,127,619
493,Christian Wood\woodch01,PF,23,MIL,11,0,52,10,22,0.455,2,4,0.5,8,18,0.444,0.5,10,13,0.769,4,14,18,2,0,0,2,2,32
494,Delon Wright\wrighde01,PG,26,TOT,51,3,955,132,309,0.427,30,96,0.313,102,213,0.479,0.476,54,63,0.857,39,95,134,118,48,16,40,57,348
495,Guerschon Yabusele\yabusgu01,PF,23,BOS,29,0,164,21,47,0.447,4,17,0.235,17,30,0.567,0.489,9,12,0.75,15,18,33,12,7,7,11,27,55
496,Nick Young\youngni01,SG,33,DEN,4,0,37,3,9,0.333,3,8,0.375,0,1,0,0.5,0,0,,0,1,1,2,0,1,2,4,9
497,Thaddeus Young\youngth01,PF,30,IND,57,57,1714,315,589,0.535,30,85,0.353,285,504,0.565,0.56,59,95,0.621,137,226,363,126,89,25,74,132,719
498,Trae Young\youngtr01,PG,20,ATL,57,57,1712,331,812,0.408,99,315,0.314,232,497,0.467,0.469,203,254,0.799,37,150,187,431,49,13,226,95,964
499,Cody Zeller\zelleco01,C,26,CHO,39,37,965,143,255,0.561,5,18,0.278,138,237,0.582,0.571,79,100,0.79,89,170,259,82,28,31,49,125,370
500,Ante Zizic\zizican01,C,22,CLE,40,11,641,107,205,0.522,0,0,,107,205,0.522,0.522,56,77,0.727,64,137,201,26,9,15,33,69,270
501,Ivica Zubac\zubaciv01,C,21,TOT,35,14,554,118,205,0.576,0,0,,118,205,0.576,0.576,60,71,0.845,55,117,172,26,4,30,39,79,296
